//MAP CONVERTED BY dmm2tgm.py THIS HEADER COMMENT PREVENTS RECONVERSION, DO NOT REMOVE
"aF" = (
/obj/structure/closet/crate/bin,
/turf/simulated/floor/tiled/milspec,
/area/centcom/living)
"aJ" = (
/obj/structure/fence/door,
/turf/simulated/floor/outdoors/newdirt/muriki,
/area/mine/explored/muriki/mountainnorth)
"aS" = (
/obj/machinery/door/airlock/centcom/nameddorm,
/turf/space,
/area/centcom/living)
"bc" = (
/obj/machinery/light,
/turf/simulated/floor/tiled/old_tile/beige,
/area/centcom/living)
"ca" = (
/obj/effect/floor_decal/corner_oldtile/beige/diagonal,
/obj/effect/floor_decal/corner_oldtile/beige,
/obj/machinery/light{
	dir = 1
	},
/turf/simulated/floor/tiled/old_tile/beige,
/area/centcom/living)
"dI" = (
/obj/structure/table/hardwoodtable,
/obj/item/device/flashlight/lamp/green{
	pixel_x = -6;
	pixel_y = 14
	},
/obj/item/device/flashlight/pen,
/turf/simulated/floor/tiled/milspec,
/area/centcom/living)
"eC" = (
/obj/structure/bed/padded,
/obj/item/weapon/bedsheet,
/obj/structure/curtain/bed,
/turf/simulated/floor/carpet/green,
/area/centcom/living)
"eF" = (
/obj/structure/bed/chair/sofa/corner/beige,
/turf/simulated/floor/carpet/green,
/area/centcom/living)
"eZ" = (
/obj/machinery/light/small/emergency{
	dir = 4
	},
/turf/simulated/floor/tiled/old_tile/beige,
/area/centcom/living)
"fe" = (
/obj/structure/closet/secure_closet/freezer/fridge,
/turf/simulated/floor/tiled/eris/white/panels,
/area/centcom/living)
"fs" = (
/obj/effect/floor_decal/steeldecal/steel_decals_central7{
	dir = 4
	},
/turf/simulated/floor/tiled/old_tile/beige,
/area/centcom/living)
"go" = (
/obj/machinery/light/small/emergency,
/turf/simulated/floor/tiled/old_tile/beige,
/area/centcom/living)
"gP" = (
/obj/structure/table/hardwoodtable,
/obj/item/weapon/card/id,
/obj/item/weapon/card/id/gold,
/turf/simulated/floor/tiled/milspec,
/area/centcom/living)
"gR" = (
/obj/structure/table/rack/shelf/steel,
/obj/item/weapon/gripper,
/obj/item/weapon/gripper/research,
/obj/item/weapon/gripper/paperwork,
/turf/simulated/floor/tiled/milspec,
/area/centcom/living)
"hr" = (
/obj/structure/bed/chair/sofa/left/beige{
	dir = 8
	},
/turf/simulated/floor/carpet/green,
/area/centcom/living)
"ic" = (
/obj/machinery/door/airlock/glass,
/turf/space,
/area/centcom/living)
"jG" = (
/obj/structure/table/rack/shelf/steel,
/obj/item/device/tape,
/obj/item/device/measuring_tape,
/obj/item/device/multitool,
/turf/simulated/floor/tiled/milspec,
/area/centcom/living)
"kM" = (
/obj/structure/mirror{
	dir = 8;
	pixel_x = -32
	},
/obj/structure/sink{
	dir = 8;
	pixel_x = -12
	},
/turf/simulated/floor/tiled/freezer,
/area/centcom/living)
"lq" = (
/obj/machinery/shower,
/obj/structure/curtain/open/privacy,
/turf/simulated/floor/tiled/freezer,
/area/centcom/living)
"lz" = (
/obj/effect/floor_decal/corner_oldtile/beige/diagonal,
/obj/effect/floor_decal/corner_oldtile/beige,
/obj/effect/floor_decal/corner_oldtile/beige/full,
/obj/effect/floor_decal/corner_oldtile/beige/full,
/obj/machinery/light{
	dir = 1
	},
/turf/simulated/floor/tiled/old_tile/beige,
/area/centcom/living)
"lA" = (
/obj/machinery/light/small/emergency{
	dir = 8
	},
/turf/simulated/floor/tiled/old_tile/beige,
/area/centcom/living)
"lD" = (
/obj/structure/table/hardwoodtable,
/obj/item/device/integrated_circuit_printer,
/obj/item/weapon/tool/wrench,
/obj/item/weapon/tool/screwdriver{
	pixel_y = 15
	},
/turf/simulated/floor/tiled/milspec,
/area/centcom/living)
"lP" = (
/obj/machinery/vending/cola,
/turf/simulated/floor/tiled/old_tile/beige,
/area/centcom/living)
"mh" = (
/obj/machinery/smartfridge/drying_rack,
/turf/simulated/floor/tiled/eris/white/panels,
/area/centcom/living)
"mw" = (
/obj/structure/table/rack/shelf/steel,
/turf/simulated/floor/tiled/freezer,
/area/centcom/living)
"mD" = (
/obj/structure/table/rack/shelf/steel,
/obj/item/taperoll,
/turf/simulated/floor/tiled/milspec,
/area/centcom/living)
"nj" = (
/turf/simulated/floor/tiled/freezer,
/area/centcom/living)
"nr" = (
/obj/structure/closet/crate/bin,
/turf/simulated/floor/tiled/freezer,
/area/centcom/living)
"nt" = (
/obj/machinery/light{
	dir = 1
	},
/turf/simulated/floor/tiled/old_tile/beige,
/area/centcom/living)
"nI" = (
/obj/structure/window/reinforced/tinted/frosted{
	dir = 8
	},
/turf/simulated/floor/carpet/green,
/area/centcom/living)
"nU" = (
/obj/machinery/power/grounding_rod/pre_mapped,
/turf/simulated/floor/outdoors/newdirt/muriki,
/area/mine/explored/muriki/mountainnorth)
"oh" = (
/obj/machinery/vending/hotfood,
/turf/simulated/floor/tiled/old_tile/beige,
/area/centcom/living)
"ox" = (
/obj/random/outcrop,
/turf/simulated/floor/outdoors/newdirt/muriki,
/area/mine/explored/muriki/mountainnorth)
"pi" = (
/obj/structure/simple_door,
/turf/simulated/floor/tiled/milspec,
/area/centcom/living)
"tw" = (
/obj/machinery/door/airlock/centcom/nameddorm,
/turf/simulated/wall,
/area/centcom/living)
"uN" = (
/obj/structure/grille,
/obj/structure/window/reinforced{
	dir = 1
	},
/obj/structure/window/reinforced,
/turf/space,
/area/centcom/living)
"uV" = (
/obj/effect/floor_decal/corner_oldtile/beige/diagonal,
/obj/effect/floor_decal/corner_oldtile/beige,
/obj/effect/floor_decal/corner_oldtile/beige/full,
/obj/effect/floor_decal/steeldecal/steel_decals_central7{
	dir = 4
	},
/turf/simulated/floor/tiled/old_tile/beige,
/area/centcom/living)
"xg" = (
/obj/machinery/vending/cigarette,
/turf/simulated/floor/tiled/old_tile/beige,
/area/centcom/living)
"xA" = (
/obj/machinery/washing_machine,
/turf/simulated/floor/tiled/freezer,
/area/centcom/living)
"xK" = (
/obj/machinery/door/airlock/glass,
/turf/simulated/floor/tiled/old_tile/beige,
/area/centcom/living)
"yb" = (
/obj/structure/fence{
	dir = 4
	},
/turf/simulated/floor/outdoors/newdirt/muriki,
/area/mine/explored/muriki/mountainnorth)
"yu" = (
/obj/structure/bed/chair/bay/comfy/blue{
	dir = 4
	},
/turf/simulated/floor/tiled/milspec,
/area/centcom/living)
"yC" = (
/obj/structure/bed/chair/sofa/right/beige,
/turf/simulated/floor/carpet/green,
/area/centcom/living)
"yK" = (
/obj/machinery/microwave{
	pixel_y = 9
	},
/obj/structure/table/hardwoodtable,
/turf/simulated/floor/carpet/green,
/area/centcom/living)
"yW" = (
/turf/simulated/floor/tiled/milspec,
/area/centcom/living)
"zk" = (
/obj/effect/floor_decal/corner_oldtile/beige/diagonal,
/obj/effect/floor_decal/corner_oldtile/beige,
/obj/effect/floor_decal/corner_oldtile/beige/full,
/turf/simulated/floor/tiled/old_tile/beige,
/area/centcom/living)
"zp" = (
/obj/structure/window/reinforced/tinted/frosted{
	dir = 4
	},
/turf/simulated/floor/tiled/milspec,
/area/centcom/living)
"zy" = (
/turf/simulated/floor/outdoors/newdirt/muriki,
/area/mine/explored/muriki/mountainnorth)
"Ad" = (
/turf/simulated/wall,
/area/centcom/living)
"AK" = (
/obj/structure/table/hardwoodtable,
/obj/item/weapon/gun/energy/sizegun,
/turf/simulated/floor/carpet/green,
/area/centcom/living)
"Bf" = (
/obj/structure/hoist,
/turf/simulated/floor/tiled/milspec,
/area/centcom/living)
"Dj" = (
/obj/machinery/vending/bepis,
/turf/simulated/floor/tiled/old_tile/beige,
/area/centcom/living)
"Ds" = (
/obj/item/hoist_kit,
/turf/simulated/floor/tiled/milspec,
/area/centcom/living)
"Eq" = (
/obj/structure/closet/secure_closet/freezer/meat,
/turf/simulated/floor/tiled/eris/white/panels,
/area/centcom/living)
"GE" = (
/obj/machinery/vending/dinnerware,
/turf/simulated/floor/tiled/milspec,
/area/centcom/living)
"GH" = (
/obj/effect/floor_decal/corner_oldtile/beige/diagonal,
/obj/effect/floor_decal/corner_oldtile/beige/full,
/turf/simulated/floor/tiled/old_tile/beige,
/area/centcom/living)
"Hm" = (
/obj/item/toy/minigibber{
	desc = "A miniature recreation of NanoTrasen's famous meat grinder. Equipped with a special interlock that prevents insertion of organic material. It functions as a trash can!"
	},
/turf/simulated/floor/tiled/milspec,
/area/centcom/living)
"IN" = (
/obj/structure/coatrack,
/turf/simulated/floor/tiled/milspec,
/area/centcom/living)
"Ky" = (
/obj/effect/floor_decal/corner_oldtile/beige/diagonal,
/obj/effect/floor_decal/corner_oldtile/beige,
/obj/effect/floor_decal/corner_oldtile/beige/full,
/obj/effect/floor_decal/corner_oldtile/beige/full,
/turf/simulated/floor/tiled/old_tile/beige,
/area/centcom/living)
"Lj" = (
/obj/structure/table/glass,
/obj/item/weapon/soap/blue_soap,
/obj/item/weapon/reagent_containers/spray/cleaner,
/turf/simulated/floor/tiled/freezer,
/area/centcom/living)
"Mc" = (
/turf/simulated/mineral/alt/ignore_mapgen/muriki,
/area/mine/explored/muriki/mountainnorth)
"NH" = (
/obj/machinery/light,
/turf/simulated/floor/outdoors/newdirt/muriki,
/area/mine/explored/muriki/mountainnorth)
"PH" = (
/turf/simulated/floor/tiled/old_tile/beige,
/area/centcom/living)
"QN" = (
/obj/machinery/vending/foodmeat,
/turf/simulated/floor/tiled/old_tile/beige,
/area/centcom/living)
"Sl" = (
/obj/structure/table/glass,
/obj/item/clothing/under/bathrobe,
/obj/item/clothing/under/bathrobe,
/obj/item/weapon/towel/random,
/obj/item/weapon/towel/random,
/obj/item/weapon/towel/random,
/obj/item/weapon/reagent_containers/spray/cleaner,
/obj/item/weapon/reagent_containers/spray/cleaner,
/turf/simulated/floor/tiled/freezer,
/area/centcom/living)
"SI" = (
/obj/machinery/librarywikicomp/personal,
/obj/structure/table/hardwoodtable,
/turf/simulated/floor/tiled/milspec,
/area/centcom/living)
"Up" = (
/obj/structure/dogbed,
/obj/item/toy/plushie/borgplushie/drake/sci,
/obj/item/toy/mecha/deathripley,
/obj/item/toy/mecha/ripley,
/obj/item/toy/plushie/green_dragon,
/obj/item/toy/plushie/teshari/b_yw,
/obj/item/toy/plushie/tabby_cat,
/turf/simulated/floor/carpet/green,
/area/centcom/living)
"Vf" = (
/obj/structure/atmopost,
/turf/simulated/floor/outdoors/newdirt/muriki,
/area/mine/explored/muriki/mountainnorth)
"We" = (
/obj/structure/table/hardwoodtable,
/obj/item/device/flashlight/lamp/green,
/turf/simulated/floor/carpet/green,
/area/centcom/living)
"WU" = (
/obj/structure/closet/wardrobe,
/turf/simulated/floor/tiled/freezer,
/area/centcom/living)
"XC" = (
/obj/structure/table/rack/shelf/steel,
/turf/simulated/floor/tiled/milspec,
/area/centcom/living)
"XO" = (
/obj/effect/floor_decal/corner_oldtile/beige/diagonal,
/obj/effect/floor_decal/corner_oldtile/beige/full,
/obj/effect/floor_decal/corner_oldtile/beige/full,
/turf/simulated/floor/tiled/old_tile/beige,
/area/centcom/living)
"Ys" = (
/turf/simulated/floor/carpet/green,
/area/centcom/living)

(1,1,1) = {"
zy
yb
zy
zy
zy
zy
zy
zy
zy
zy
zy
Ad
yW
yW
yW
Ad
Ad
Ad
PH
xK
Ad
Ad
xK
PH
Ad
Ad
Ad
Ad
Ad
Ad
Ad
Ad
"}
(2,1,1) = {"
zy
yb
zy
zy
zy
zy
zy
zy
zy
zy
zy
Ad
yW
yW
yW
yW
yW
Ad
oh
PH
fs
PH
PH
PH
Ad
yW
yW
yW
yW
yW
yW
Ad
"}
(3,1,1) = {"
zy
aJ
zy
zy
zy
zy
zy
zy
zy
zy
zy
Ad
yW
yW
yW
yW
yW
Ad
QN
eZ
PH
PH
PH
PH
Ad
yW
yW
yW
yW
yW
yW
Ad
"}
(4,1,1) = {"
zy
yb
zy
zy
zy
zy
zy
zy
zy
zy
zy
Ad
yW
yW
yW
yW
yW
Ad
GE
Ad
PH
PH
Ad
Ad
Ad
Ad
Ad
Ad
Ad
Ad
Ad
Ad
"}
(5,1,1) = {"
zy
yb
zy
zy
zy
ox
zy
zy
zy
zy
zy
Ad
Ad
Ad
Ad
Ad
Ad
Ad
Ad
Ad
PH
bc
Ad
yW
yW
yW
Ad
yW
yW
yW
yW
Ad
"}
(6,1,1) = {"
zy
yb
zy
zy
zy
zy
zy
zy
zy
zy
zy
Ad
yW
yW
yW
yW
yW
yW
yW
Ad
nt
PH
tw
yW
yW
yW
yW
yW
Ad
yW
yW
Ad
"}
(7,1,1) = {"
zy
yb
zy
ox
zy
zy
zy
zy
zy
zy
zy
Ad
yW
yW
yW
yW
yW
yW
yW
aS
PH
bc
Ad
yW
yW
yW
yW
yW
Ad
yW
yW
Ad
"}
(8,1,1) = {"
zy
yb
ox
zy
zy
zy
nU
zy
ox
zy
zy
Ad
yW
yW
yW
yW
yW
yW
yW
Ad
lz
go
Ad
yW
yW
yW
Ad
yW
yW
yW
yW
Ad
"}
(9,1,1) = {"
zy
yb
zy
zy
zy
zy
zy
zy
zy
zy
zy
Ad
Ad
Ad
Ad
Ad
Ad
Ad
Ad
Ad
Ky
PH
Ad
Ad
Ad
Ad
Ad
Ad
Ad
Ad
Ad
Ad
"}
(10,1,1) = {"
Mc
yb
zy
zy
zy
zy
zy
zy
zy
zy
zy
Ad
lq
nj
Sl
Ad
nj
kM
Lj
Ad
XO
PH
Ad
yW
yW
yW
yW
Ad
yW
yW
yW
Ad
"}
(11,1,1) = {"
Mc
yb
zy
zy
zy
zy
zy
zy
zy
zy
zy
Ad
xA
nj
nj
pi
nj
nj
nr
Ad
uV
PH
Ad
yW
yW
yW
yW
Ad
yW
yW
yW
Ad
"}
(12,1,1) = {"
Mc
Mc
zy
zy
zy
zy
ox
zy
zy
zy
zy
Ad
Ad
Ad
Ad
Ad
mw
nj
WU
Ad
Ky
bc
Ad
yW
yW
yW
yW
Ad
yW
yW
yW
Ad
"}
(13,1,1) = {"
Mc
Mc
Mc
zy
zy
zy
zy
zy
zy
zy
NH
Ad
Bf
Ds
XC
Ad
Ad
pi
Ad
Ad
Ky
PH
tw
yW
yW
yW
yW
Ad
yW
yW
yW
Ad
"}
(14,1,1) = {"
Mc
Mc
Mc
zy
zy
zy
zy
zy
zy
zy
NH
Ad
zp
zp
yW
Ad
Hm
yW
yW
Ad
zk
bc
Ad
yW
yW
yW
yW
Ad
yW
yW
yW
Ad
"}
(15,1,1) = {"
Mc
Mc
Mc
Mc
zy
zy
zy
zy
zy
zy
zy
uN
lD
yW
yW
pi
yW
yW
IN
Ad
lz
PH
Ad
yW
yW
yW
yW
Ad
yW
yW
yW
Ad
"}
(16,1,1) = {"
Mc
Mc
Mc
Mc
zy
ox
zy
zy
zy
zy
zy
uN
gP
yW
yW
Ad
aF
yW
yW
tw
zk
PH
Ad
yW
yW
yW
yW
Ad
yW
yW
yW
Ad
"}
(17,1,1) = {"
Mc
Mc
Mc
zy
zy
zy
zy
zy
zy
zy
zy
uN
gR
yW
yu
Ad
yK
Ys
dI
Ad
ca
go
Ad
yW
yW
yW
yW
Ad
yW
yW
yW
Ad
"}
(18,1,1) = {"
Mc
Mc
Mc
Mc
zy
zy
zy
ox
zy
zy
zy
uN
mD
yW
SI
Ad
AK
Ys
Eq
Ad
zk
PH
Ad
yW
yW
yW
yW
yW
yW
yW
yW
Ad
"}
(19,1,1) = {"
Mc
Mc
Mc
Mc
zy
zy
zy
zy
zy
zy
zy
uN
jG
yW
yW
Ad
Ys
Ys
fe
Ad
zk
PH
Ad
yW
yW
yW
yW
Ad
yW
yW
yW
Ad
"}
(20,1,1) = {"
Mc
Mc
Mc
zy
zy
zy
zy
zy
zy
zy
NH
Ad
nI
nI
Ys
Ad
yC
Ys
mh
Ad
zk
PH
Ad
yW
yW
yW
yW
Ad
yW
yW
yW
Ad
"}
(21,1,1) = {"
Mc
Mc
Mc
zy
zy
ox
ox
zy
zy
zy
NH
Ad
eC
eC
Up
Ad
eF
hr
We
Ad
uV
PH
Ad
yW
yW
yW
yW
Ad
yW
yW
yW
Ad
"}
(22,1,1) = {"
Mc
Mc
Mc
zy
zy
zy
zy
zy
zy
zy
zy
Ad
Ad
Ad
Ad
Ad
Ad
Ad
Ad
Ad
zk
PH
Ad
Ad
Ad
Ad
Ad
Ad
Ad
Ad
Ad
Ad
"}
(23,1,1) = {"
Mc
Mc
Mc
Mc
zy
zy
zy
zy
ox
zy
zy
Ad
yW
yW
yW
yW
yW
yW
yW
Ad
zk
PH
Ad
yW
yW
yW
yW
yW
yW
yW
yW
Ad
"}
(24,1,1) = {"
Mc
Mc
Mc
Mc
zy
zy
Vf
zy
zy
zy
zy
Ad
yW
yW
yW
yW
yW
yW
yW
Ad
GH
PH
Ad
yW
yW
yW
yW
yW
yW
yW
yW
Ad
"}
(25,1,1) = {"
Mc
Mc
Mc
Mc
zy
zy
zy
zy
zy
zy
zy
Ad
Ad
Ad
Ad
Ad
Ad
Ad
Ad
Ad
nt
PH
Ad
Ad
Ad
Ad
Ad
Ad
Ad
Ad
Ad
Ad
"}
(26,1,1) = {"
Mc
Mc
Mc
Mc
zy
zy
zy
zy
zy
zy
zy
Ad
yW
yW
yW
yW
yW
yW
yW
aS
PH
bc
Ad
yW
yW
Ad
yW
yW
yW
yW
yW
Ad
"}
(27,1,1) = {"
Mc
Mc
Mc
Mc
Mc
zy
zy
zy
zy
zy
zy
Ad
yW
yW
yW
yW
yW
yW
yW
Ad
nt
PH
aS
yW
yW
yW
yW
yW
yW
yW
yW
Ad
"}
(28,1,1) = {"
Mc
Mc
Mc
Mc
Mc
Mc
zy
zy
zy
zy
zy
Ad
yW
yW
yW
yW
Ad
Ad
Ad
Ad
PH
bc
Ad
yW
yW
Ad
yW
yW
yW
yW
yW
Ad
"}
(29,1,1) = {"
Mc
Mc
Mc
Mc
Mc
Mc
zy
zy
zy
Mc
Mc
Ad
yW
yW
yW
yW
Ad
Dj
PH
PH
PH
PH
Ad
Ad
Ad
Ad
Ad
Ad
Ad
Ad
Ad
Ad
"}
(30,1,1) = {"
Mc
Mc
Mc
Mc
Mc
Mc
Mc
Mc
Mc
Mc
Mc
Ad
yW
yW
yW
yW
Ad
xg
PH
lA
PH
PH
lA
PH
PH
Ad
yW
yW
yW
yW
yW
yW
"}
(31,1,1) = {"
Mc
Mc
Mc
Mc
Mc
Mc
Mc
Mc
Mc
Mc
Mc
Ad
yW
yW
yW
yW
Ad
lP
PH
PH
fs
PH
PH
PH
PH
Ad
yW
yW
yW
yW
yW
yW
"}
(32,1,1) = {"
Mc
Mc
Mc
Mc
Mc
Mc
Mc
Mc
Mc
Mc
Mc
Ad
yW
yW
yW
yW
Ad
Ad
Ad
ic
Ad
Ad
ic
Ad
Ad
Ad
yW
yW
yW
yW
yW
yW
"}
