//MAP CONVERTED BY dmm2tgm.py THIS HEADER COMMENT PREVENTS RECONVERSION, DO NOT REMOVE
"af" = (
/obj/effect/floor_decal/borderfloor{
	dir = 1
	},
/obj/effect/floor_decal/corner/green/border{
	dir = 1
	},
/obj/effect/floor_decal/corner/green/border{
	dir = 1
	},
/turf/simulated/floor/tiled/old_tile/beige,
/area/centcom/living)
"as" = (
/obj/item/hoist_kit,
/turf/simulated/floor/tiled/milspec,
/area/centcom/living)
"bc" = (
/turf/simulated/floor/tiled/milspec,
/area/centcom/living)
"cs" = (
/obj/structure/fence/door,
/turf/simulated/floor/outdoors/newdirt/muriki,
/area/mine/explored/muriki/mountainnorth)
"cw" = (
/obj/machinery/vending/bepis,
/obj/effect/floor_decal/corner/green/border{
	dir = 1
	},
/obj/effect/floor_decal/corner/green/border{
	dir = 8
	},
/turf/simulated/floor/tiled/old_tile/beige,
/area/centcom/living)
"dy" = (
/obj/machinery/vending/cigarette,
/obj/effect/floor_decal/corner/green/border{
	dir = 1
	},
/turf/simulated/floor/tiled/old_tile/beige,
/area/centcom/living)
"dN" = (
/obj/effect/floor_decal/borderfloor,
/obj/effect/floor_decal/corner/green/border,
/turf/simulated/floor/tiled/old_tile/beige,
/area/centcom/living)
"eG" = (
/obj/structure/dogbed,
/obj/item/toy/plushie/borgplushie/drake/sci,
/obj/item/toy/mecha/deathripley,
/obj/item/toy/mecha/ripley,
/obj/item/toy/plushie/green_dragon,
/obj/item/toy/plushie/teshari/b_yw,
/obj/item/toy/plushie/tabby_cat,
/turf/simulated/floor/carpet/green,
/area/centcom/living)
"fc" = (
/obj/machinery/librarywikicomp/personal,
/obj/structure/table/hardwoodtable,
/turf/simulated/floor/tiled/milspec,
/area/centcom/living)
"ff" = (
/obj/machinery/atmospherics/pipe/simple/hidden/scrubbers{
	dir = 4
	},
/obj/machinery/atmospherics/pipe/simple/hidden/scrubbers{
	dir = 9
	},
/obj/machinery/atmospherics/pipe/simple/hidden/supply{
	dir = 4
	},
/obj/machinery/atmospherics/pipe/simple/hidden/supply{
	dir = 10
	},
/obj/structure/cable/green{
	d1 = 4;
	d2 = 8;
	icon_state = "4-8"
	},
/turf/simulated/floor/tiled/old_tile/beige,
/area/centcom/living)
"fi" = (
/obj/machinery/atmospherics/pipe/simple/hidden/scrubbers{
	dir = 4
	},
/obj/machinery/atmospherics/pipe/simple/hidden/scrubbers{
	dir = 9
	},
/obj/machinery/atmospherics/pipe/simple/hidden/supply{
	dir = 4
	},
/obj/machinery/atmospherics/pipe/simple/hidden/supply{
	dir = 10
	},
/obj/structure/cable/green{
	d1 = 4;
	d2 = 8;
	icon_state = "4-8"
	},
/obj/machinery/atmospherics/pipe/simple/hidden/scrubbers{
	dir = 4
	},
/turf/simulated/floor/tiled/old_tile/beige,
/area/centcom/living)
"fn" = (
/obj/structure/window/reinforced/tinted/frosted{
	dir = 8
	},
/turf/simulated/floor/carpet/green,
/area/centcom/living)
"fL" = (
/obj/structure/hoist,
/turf/simulated/floor/tiled/milspec,
/area/centcom/living)
"gX" = (
/obj/machinery/light_switch{
	dir = 1;
	pixel_y = -26
	},
/turf/simulated/floor/tiled/milspec,
/area/centcom/living)
"hl" = (
/obj/structure/window/reinforced/tinted/frosted{
	dir = 4
	},
/turf/simulated/floor/tiled/milspec,
/area/centcom/living)
"hV" = (
/obj/machinery/shower,
/obj/structure/curtain/open/privacy,
/turf/simulated/floor/tiled/freezer,
/area/centcom/living)
"ip" = (
/obj/structure/table/rack/shelf/steel,
/obj/item/device/tape,
/obj/item/device/measuring_tape,
/obj/item/device/multitool,
/turf/simulated/floor/tiled/milspec,
/area/centcom/living)
"iz" = (
/obj/machinery/vending/hotfood,
/obj/effect/floor_decal/corner/green/border{
	dir = 1
	},
/turf/simulated/floor/tiled/old_tile/beige,
/area/centcom/living)
"iJ" = (
/obj/machinery/vending/cola,
/obj/effect/floor_decal/corner/green/border{
	dir = 1
	},
/turf/simulated/floor/tiled/old_tile/beige,
/area/centcom/living)
"jj" = (
/obj/structure/bed/chair/sofa/left/beige{
	dir = 8
	},
/turf/simulated/floor/carpet/green,
/area/centcom/living)
"km" = (
/obj/item/toy/minigibber{
	desc = "A miniature recreation of NanoTrasen's famous meat grinder. Equipped with a special interlock that prevents insertion of organic material. It functions as a trash can!"
	},
/turf/simulated/floor/tiled/milspec,
/area/centcom/living)
"kJ" = (
/obj/effect/floor_decal/corner/green/border,
/obj/effect/floor_decal/corner/green/border{
	dir = 8
	},
/turf/simulated/floor/tiled/old_tile/beige,
/area/centcom/living)
"lg" = (
/obj/effect/floor_decal/corner/green/border{
	dir = 1
	},
/obj/effect/floor_decal/borderfloor{
	dir = 1
	},
/obj/effect/floor_decal/corner/green/border{
	dir = 1
	},
/turf/simulated/floor/tiled/old_tile/beige,
/area/centcom/living)
"lP" = (
/obj/structure/extinguisher_cabinet{
	pixel_x = 5;
	pixel_y = 30
	},
/obj/effect/floor_decal/borderfloor{
	dir = 1
	},
/obj/effect/floor_decal/corner/green/border{
	dir = 1
	},
/turf/simulated/floor/tiled/old_tile/beige,
/area/centcom/living)
"mf" = (
/obj/structure/bed/chair/sofa/right/beige,
/turf/simulated/floor/carpet/green,
/area/centcom/living)
"ml" = (
/obj/structure/mirror{
	dir = 8;
	pixel_x = -32
	},
/obj/structure/sink{
	dir = 8;
	pixel_x = -12
	},
/turf/simulated/floor/tiled/freezer,
/area/centcom/living)
"nt" = (
/obj/effect/floor_decal/steeldecal/steel_decals_central7{
	dir = 4
	},
/obj/effect/floor_decal/borderfloor{
	dir = 1
	},
/obj/effect/floor_decal/corner/green/border{
	dir = 1
	},
/turf/simulated/floor/tiled/old_tile/beige,
/area/centcom/living)
"oK" = (
/turf/simulated/floor/carpet/green,
/area/centcom/living)
"pr" = (
/obj/machinery/atmospherics/unary/vent_scrubber/on,
/obj/effect/floor_decal/corner/green/bordercorner{
	dir = 4
	},
/turf/simulated/floor/tiled/old_tile/beige,
/area/centcom/living)
"pL" = (
/obj/structure/coatrack,
/obj/machinery/light_switch{
	dir = 1;
	pixel_y = -26
	},
/turf/simulated/floor/tiled/milspec,
/area/centcom/living)
"pM" = (
/obj/machinery/light,
/turf/simulated/floor/outdoors/newdirt/muriki,
/area/mine/explored/muriki/mountainnorth)
"pP" = (
/obj/machinery/light,
/obj/effect/floor_decal/borderfloor,
/obj/effect/floor_decal/corner/green/border,
/turf/simulated/floor/tiled/old_tile/beige,
/area/centcom/living)
"pY" = (
/obj/structure/simple_door,
/turf/simulated/floor/tiled/milspec,
/area/centcom/living)
"qD" = (
/obj/machinery/door/airlock/glass{
	name = "Security Checkpoint"
	},
/turf/simulated/floor/tiled/old_tile/beige,
/area/centcom/living)
"qN" = (
/obj/machinery/light/small/emergency,
/obj/effect/floor_decal/borderfloor,
/obj/effect/floor_decal/corner/green/border,
/turf/simulated/floor/tiled/old_tile/beige,
/area/centcom/living)
"rA" = (
/obj/machinery/vending/dinnerware,
/obj/effect/floor_decal/corner/green/border{
	dir = 1
	},
/obj/effect/floor_decal/corner/green/border{
	dir = 4
	},
/turf/simulated/floor/tiled/milspec,
/area/centcom/living)
"th" = (
/obj/machinery/atmospherics/unary/vent_scrubber/on,
/obj/effect/floor_decal/corner/green/bordercorner{
	dir = 1
	},
/turf/simulated/floor/tiled/old_tile/beige,
/area/centcom/living)
"ty" = (
/obj/effect/landmark/start,
/obj/effect/landmark{
	name = "JoinLateElevator"
	},
/obj/effect/floor_decal/corner/green/border,
/turf/simulated/floor/tiled/old_tile/beige,
/area/muriki/arriveelev)
"ur" = (
/obj/machinery/light/small/emergency{
	dir = 4
	},
/obj/effect/floor_decal/corner/green/border{
	dir = 4
	},
/turf/simulated/floor/tiled/old_tile/beige,
/area/centcom/living)
"uO" = (
/obj/structure/cable/green{
	d1 = 4;
	d2 = 8;
	icon_state = "4-8"
	},
/obj/machinery/atmospherics/pipe/simple/hidden/supply{
	dir = 4
	},
/obj/machinery/atmospherics/pipe/simple/hidden/scrubbers{
	dir = 4
	},
/turf/simulated/floor/tiled/old_tile/beige,
/area/centcom/living)
"uP" = (
/obj/machinery/light{
	dir = 1
	},
/obj/effect/floor_decal/borderfloor{
	dir = 1
	},
/obj/effect/floor_decal/corner/green/border{
	dir = 1
	},
/turf/simulated/floor/tiled/old_tile/beige,
/area/centcom/living)
"uY" = (
/obj/structure/closet/secure_closet/freezer/fridge,
/turf/simulated/floor/tiled/eris/white/panels,
/area/centcom/living)
"yG" = (
/obj/machinery/atmospherics/pipe/simple/hidden/scrubbers{
	dir = 4
	},
/obj/machinery/atmospherics/pipe/simple/hidden/supply{
	dir = 4
	},
/obj/structure/cable/green{
	d1 = 4;
	d2 = 8;
	icon_state = "4-8"
	},
/turf/simulated/floor/tiled/old_tile/beige,
/area/centcom/living)
"zd" = (
/obj/effect/landmark/start,
/obj/effect/landmark{
	name = "JoinLateElevator"
	},
/turf/simulated/floor/tiled/old_tile/beige,
/area/muriki/arriveelev)
"zz" = (
/turf/simulated/wall,
/area/centcom/living)
"zX" = (
/obj/machinery/power/smes,
/turf/simulated/floor/tiled/milspec,
/area/centcom/living)
"Ao" = (
/obj/machinery/light/small/emergency{
	dir = 8
	},
/obj/effect/floor_decal/corner/green/border{
	dir = 8
	},
/turf/simulated/floor/tiled/old_tile/beige,
/area/centcom/living)
"Aq" = (
/obj/machinery/power/grounding_rod/pre_mapped,
/turf/simulated/floor/outdoors/newdirt/muriki,
/area/mine/explored/muriki/mountainnorth)
"AN" = (
/obj/structure/atmopost,
/turf/simulated/floor/outdoors/newdirt/muriki,
/area/mine/explored/muriki/mountainnorth)
"Be" = (
/obj/machinery/microwave{
	pixel_y = 9
	},
/obj/structure/table/hardwoodtable,
/turf/simulated/floor/carpet/green,
/area/centcom/living)
"BC" = (
/obj/effect/floor_decal/corner/green/bordercorner{
	dir = 8
	},
/turf/simulated/floor/tiled/old_tile/beige,
/area/centcom/living)
"BG" = (
/turf/simulated/floor/tiled/old_tile/beige,
/area/centcom/living)
"BW" = (
/obj/structure/table/rack/shelf/steel,
/turf/simulated/floor/tiled/freezer,
/area/centcom/living)
"Cc" = (
/obj/machinery/light_switch{
	dir = 8;
	pixel_x = 23;
	pixel_y = 24
	},
/turf/simulated/floor/tiled/freezer,
/area/centcom/living)
"Ck" = (
/obj/effect/floor_decal/steeldecal/steel_decals_central7{
	dir = 4
	},
/turf/simulated/floor/tiled/old_tile/beige,
/area/centcom/living)
"Cu" = (
/obj/effect/floor_decal/corner/green/border{
	dir = 8
	},
/turf/simulated/floor/tiled/old_tile/beige,
/area/centcom/living)
"CW" = (
/obj/machinery/atmospherics/pipe/simple/hidden/scrubbers{
	dir = 4
	},
/obj/machinery/atmospherics/pipe/simple/hidden/supply{
	dir = 4
	},
/obj/structure/cable/green{
	d1 = 4;
	d2 = 8;
	icon_state = "4-8"
	},
/obj/structure/cable/green{
	d1 = 1;
	d2 = 8;
	icon_state = "1-8"
	},
/turf/simulated/floor/tiled/old_tile/beige,
/area/centcom/living)
"CX" = (
/obj/machinery/door/airlock/centcom/nameddorm,
/turf/space,
/area/centcom/living)
"DA" = (
/obj/structure/closet/wardrobe,
/turf/simulated/floor/tiled/freezer,
/area/centcom/living)
"FR" = (
/obj/machinery/atmospherics/pipe/simple/hidden/supply{
	dir = 4
	},
/obj/machinery/atmospherics/pipe/simple/hidden/scrubbers{
	dir = 4
	},
/turf/simulated/floor/tiled/old_tile/beige,
/area/centcom/living)
"Gl" = (
/obj/item/device/geiger/wall{
	pixel_y = 30
	},
/turf/simulated/floor/tiled/milspec,
/area/centcom/living)
"Gt" = (
/turf/simulated/floor/outdoors/newdirt/muriki,
/area/mine/explored/muriki/mountainnorth)
"GD" = (
/obj/random/outcrop,
/turf/simulated/floor/outdoors/newdirt/muriki,
/area/mine/explored/muriki/mountainnorth)
"GF" = (
/obj/effect/floor_decal/borderfloor{
	dir = 1
	},
/obj/effect/floor_decal/corner/green/border{
	dir = 1
	},
/turf/simulated/floor/tiled/old_tile/beige,
/area/centcom/living)
"Hb" = (
/obj/machinery/alarm{
	pixel_y = 26
	},
/turf/simulated/floor/tiled/milspec,
/area/centcom/living)
"Ig" = (
/obj/machinery/power/fusion_core,
/turf/simulated/floor/tiled/milspec,
/area/centcom/living)
"Il" = (
/obj/structure/table/hardwoodtable,
/obj/item/weapon/card/id,
/obj/item/weapon/card/id/gold,
/turf/simulated/floor/tiled/milspec,
/area/centcom/living)
"IP" = (
/obj/structure/bed/padded,
/obj/item/weapon/bedsheet,
/obj/structure/curtain/bed,
/turf/simulated/floor/carpet/green,
/area/centcom/living)
"JN" = (
/obj/machinery/door/airlock/centcom/nameddorm,
/turf/simulated/floor/tiled/milspec,
/area/centcom/living)
"JS" = (
/turf/simulated/floor/tiled/freezer,
/area/centcom/living)
"JU" = (
/obj/machinery/atmospherics/pipe/simple/hidden/scrubbers{
	dir = 4
	},
/obj/machinery/atmospherics/pipe/simple/hidden/scrubbers{
	dir = 9
	},
/obj/machinery/atmospherics/pipe/simple/hidden/supply{
	dir = 4
	},
/obj/machinery/atmospherics/pipe/simple/hidden/supply{
	dir = 10
	},
/obj/structure/cable/green{
	d1 = 4;
	d2 = 8;
	icon_state = "4-8"
	},
/obj/machinery/atmospherics/pipe/simple/hidden/supply{
	dir = 4
	},
/obj/machinery/atmospherics/pipe/simple/hidden/scrubbers{
	dir = 4
	},
/turf/simulated/floor/tiled/old_tile/beige,
/area/centcom/living)
"Kz" = (
/obj/machinery/power/smes,
/obj/machinery/power/smes,
/turf/simulated/floor/tiled/milspec,
/area/centcom/living)
"KC" = (
/obj/structure/closet/crate/bin,
/turf/simulated/floor/tiled/milspec,
/area/centcom/living)
"KW" = (
/obj/structure/table/rack/shelf/steel,
/turf/simulated/floor/tiled/milspec,
/area/centcom/living)
"Lc" = (
/obj/machinery/door/airlock/centcom/nameddorm,
/turf/simulated/wall,
/area/centcom/living)
"LW" = (
/obj/structure/table/hardwoodtable,
/obj/item/device/flashlight/lamp/green{
	pixel_x = -6;
	pixel_y = 14
	},
/obj/item/device/flashlight/pen,
/turf/simulated/floor/tiled/milspec,
/area/centcom/living)
"Mj" = (
/obj/machinery/washing_machine,
/turf/simulated/floor/tiled/freezer,
/area/centcom/living)
"Nw" = (
/obj/structure/bed/chair/bay/comfy/blue{
	dir = 4
	},
/turf/simulated/floor/tiled/milspec,
/area/centcom/living)
"Ou" = (
/obj/machinery/atmospherics/pipe/simple/hidden/scrubbers{
	dir = 4
	},
/obj/machinery/atmospherics/pipe/simple/hidden/supply{
	dir = 4
	},
/obj/structure/cable/green{
	d1 = 4;
	d2 = 8;
	icon_state = "4-8"
	},
/obj/effect/catwalk_plated,
/turf/simulated/floor/tiled/old_tile/beige,
/area/centcom/living)
"OA" = (
/obj/structure/table/glass,
/obj/item/clothing/under/bathrobe,
/obj/item/clothing/under/bathrobe,
/obj/item/weapon/towel/random,
/obj/item/weapon/towel/random,
/obj/item/weapon/towel/random,
/obj/item/weapon/reagent_containers/spray/cleaner,
/obj/item/weapon/reagent_containers/spray/cleaner,
/turf/simulated/floor/tiled/freezer,
/area/centcom/living)
"Pu" = (
/obj/effect/landmark/start,
/obj/effect/landmark{
	name = "JoinLateElevator"
	},
/obj/effect/floor_decal/corner/green/bordercorner,
/turf/simulated/floor/tiled/old_tile/beige,
/area/muriki/arriveelev)
"PO" = (
/obj/structure/closet/secure_closet/freezer/meat,
/turf/simulated/floor/tiled/eris/white/panels,
/area/centcom/living)
"Qr" = (
/obj/structure/fence{
	dir = 4
	},
/turf/simulated/floor/outdoors/newdirt/muriki,
/area/mine/explored/muriki/mountainnorth)
"Rh" = (
/obj/structure/table/hardwoodtable,
/obj/item/weapon/gun/energy/sizegun,
/turf/simulated/floor/carpet/green,
/area/centcom/living)
"SB" = (
/turf/simulated/mineral/alt/ignore_mapgen/muriki,
/area/mine/explored/muriki/mountainnorth)
"SE" = (
/obj/machinery/firealarm{
	dir = 1;
	pixel_y = -30
	},
/obj/machinery/atmospherics/unary/vent_pump/on{
	dir = 1
	},
/obj/effect/floor_decal/borderfloor,
/obj/effect/floor_decal/corner/green/border,
/turf/simulated/floor/tiled/old_tile/beige,
/area/centcom/living)
"SI" = (
/obj/structure/table/glass,
/obj/item/weapon/soap/blue_soap,
/obj/item/weapon/reagent_containers/spray/cleaner,
/turf/simulated/floor/tiled/freezer,
/area/centcom/living)
"Tf" = (
/obj/structure/closet/crate/bin,
/turf/simulated/floor/tiled/freezer,
/area/centcom/living)
"Tr" = (
/obj/machinery/smartfridge/drying_rack,
/turf/simulated/floor/tiled/eris/white/panels,
/area/centcom/living)
"Tt" = (
/obj/machinery/door/airlock/centcom/nameddorm{
	matchnames = list("Tobin", "Praethius");
	name = "Tobin's Residence"
	},
/turf/space,
/area/centcom/living)
"Uz" = (
/obj/structure/grille,
/obj/structure/window/reinforced{
	dir = 1
	},
/obj/structure/window/reinforced,
/turf/space,
/area/centcom/living)
"Vf" = (
/obj/machinery/vending/foodmeat,
/obj/effect/floor_decal/corner/green/border{
	dir = 1
	},
/turf/simulated/floor/tiled/old_tile/beige,
/area/centcom/living)
"Vo" = (
/obj/machinery/power/apc{
	name = "south bump";
	pixel_y = -26
	},
/turf/simulated/floor/tiled/milspec,
/area/centcom/living)
"VH" = (
/obj/structure/table/rack/shelf/steel,
/obj/item/weapon/gripper,
/obj/item/weapon/gripper/research,
/obj/item/weapon/gripper/paperwork,
/turf/simulated/floor/tiled/milspec,
/area/centcom/living)
"VT" = (
/obj/structure/bed/chair/sofa/corner/beige,
/turf/simulated/floor/carpet/green,
/area/centcom/living)
"WP" = (
/obj/machinery/vending/wallmed1{
	pixel_y = -32
	},
/turf/simulated/floor/tiled/milspec,
/area/centcom/living)
"Xs" = (
/obj/structure/table/hardwoodtable,
/obj/item/device/integrated_circuit_printer,
/obj/item/weapon/tool/wrench,
/obj/item/weapon/tool/screwdriver{
	pixel_y = 15
	},
/turf/simulated/floor/tiled/milspec,
/area/centcom/living)
"Xu" = (
/obj/structure/table/rack/shelf/steel,
/obj/item/taperoll,
/turf/simulated/floor/tiled/milspec,
/area/centcom/living)
"XI" = (
/obj/machinery/light{
	dir = 1
	},
/obj/machinery/atmospherics/unary/vent_scrubber/on,
/obj/effect/floor_decal/borderfloor{
	dir = 1
	},
/obj/effect/floor_decal/corner/green/border{
	dir = 1
	},
/obj/effect/floor_decal/corner/green/border{
	dir = 1
	},
/turf/simulated/floor/tiled/old_tile/beige,
/area/centcom/living)
"XV" = (
/obj/machinery/atmospherics/unary/vent_pump/on{
	dir = 1
	},
/obj/effect/floor_decal/borderfloor,
/obj/effect/floor_decal/corner/green/border,
/turf/simulated/floor/tiled/old_tile/beige,
/area/centcom/living)
"Yx" = (
/obj/effect/floor_decal/corner/green/border,
/turf/simulated/floor/tiled/old_tile/beige,
/area/centcom/living)
"YJ" = (
/obj/structure/table/hardwoodtable,
/obj/item/device/flashlight/lamp/green,
/turf/simulated/floor/carpet/green,
/area/centcom/living)
"YL" = (
/obj/effect/landmark/start,
/obj/effect/landmark{
	name = "JoinLateElevator"
	},
/obj/effect/floor_decal/corner/green/border,
/obj/effect/floor_decal/corner/green/border{
	dir = 4
	},
/turf/simulated/floor/tiled/old_tile/beige,
/area/muriki/arriveelev)

(1,1,1) = {"
Gt
Qr
Gt
Gt
Gt
Gt
Gt
Gt
Gt
Gt
Gt
zz
bc
bc
bc
zz
zz
zz
zz
qD
zz
zz
qD
zz
zz
zz
zz
zz
zz
zz
zz
zz
"}
(2,1,1) = {"
Gt
Qr
Gt
Gt
Gt
Gt
Gt
Gt
Gt
Gt
Gt
zz
bc
bc
bc
bc
bc
zz
iz
BG
Ck
FR
zd
ty
zz
bc
bc
bc
bc
bc
bc
zz
"}
(3,1,1) = {"
Gt
cs
Gt
Gt
Gt
Gt
Gt
Gt
Gt
Gt
Gt
zz
bc
bc
bc
bc
bc
zz
Vf
BG
BG
FR
Pu
YL
zz
bc
bc
bc
bc
bc
bc
zz
"}
(4,1,1) = {"
Gt
Qr
Gt
Gt
Gt
Gt
Gt
Gt
Gt
Gt
Gt
zz
bc
bc
bc
bc
bc
zz
rA
ur
pr
fi
XV
zz
zz
zz
zz
zz
zz
zz
zz
zz
"}
(5,1,1) = {"
Gt
Qr
Gt
Gt
Gt
GD
Gt
Gt
Gt
Gt
Gt
zz
zz
zz
zz
zz
zz
zz
zz
zz
GF
Ou
pP
zz
bc
bc
zz
bc
bc
bc
bc
zz
"}
(6,1,1) = {"
Gt
Qr
Gt
Gt
Gt
Gt
Gt
Gt
Gt
Gt
Gt
zz
bc
bc
bc
bc
bc
bc
bc
zz
uP
yG
dN
JN
bc
bc
bc
bc
zz
bc
bc
zz
"}
(7,1,1) = {"
Gt
Qr
Gt
GD
Gt
Gt
Gt
Gt
Gt
Gt
Gt
zz
bc
bc
bc
bc
bc
bc
bc
CX
GF
yG
pP
zz
bc
bc
bc
bc
zz
bc
bc
zz
"}
(8,1,1) = {"
Gt
Qr
GD
Gt
Gt
Gt
Aq
Gt
GD
Gt
Gt
zz
bc
bc
bc
bc
bc
bc
WP
zz
uP
yG
qN
zz
bc
bc
zz
bc
bc
bc
bc
zz
"}
(9,1,1) = {"
Gt
Qr
Gt
Gt
Gt
Gt
Gt
Gt
Gt
Gt
Gt
zz
zz
zz
zz
zz
zz
zz
zz
zz
lP
yG
dN
zz
zz
zz
zz
zz
zz
zz
zz
zz
"}
(10,1,1) = {"
SB
Qr
Gt
Gt
Gt
Gt
Gt
Gt
Gt
Gt
Gt
zz
hV
JS
OA
zz
JS
ml
SI
zz
GF
yG
dN
zz
Hb
bc
bc
zz
bc
bc
bc
zz
"}
(11,1,1) = {"
SB
Qr
Gt
Gt
Gt
Gt
Gt
Gt
Gt
Gt
Gt
zz
Mj
JS
JS
pY
JS
JS
Tf
zz
nt
yG
dN
zz
Gl
bc
bc
zz
bc
bc
bc
zz
"}
(12,1,1) = {"
SB
SB
Gt
Gt
Gt
Gt
GD
Gt
Gt
Gt
Gt
zz
zz
zz
zz
zz
BW
Cc
DA
zz
GF
yG
pP
zz
bc
bc
bc
zz
bc
bc
bc
zz
"}
(13,1,1) = {"
SB
SB
SB
Gt
Gt
Gt
Gt
Gt
Gt
Gt
pM
zz
fL
as
KW
zz
zz
pY
zz
zz
GF
yG
dN
Lc
bc
bc
bc
zz
bc
bc
bc
zz
"}
(14,1,1) = {"
SB
SB
SB
Gt
Gt
Gt
Gt
Gt
Gt
Gt
pM
zz
hl
hl
bc
zz
km
bc
Vo
zz
af
yG
pP
zz
bc
bc
bc
zz
bc
bc
bc
zz
"}
(15,1,1) = {"
SB
SB
SB
SB
Gt
Gt
Gt
Gt
Gt
Gt
Gt
Uz
Xs
bc
bc
pY
bc
bc
pL
zz
XI
ff
SE
zz
bc
bc
bc
zz
bc
bc
bc
zz
"}
(16,1,1) = {"
SB
SB
SB
SB
Gt
GD
Gt
Gt
Gt
Gt
Gt
Uz
Il
bc
gX
zz
KC
bc
bc
Tt
GF
CW
dN
zz
bc
bc
bc
zz
bc
bc
bc
zz
"}
(17,1,1) = {"
SB
SB
SB
Gt
Gt
Gt
Gt
Gt
Gt
Gt
Gt
Uz
VH
bc
Nw
zz
Be
oK
LW
zz
uP
yG
qN
zz
bc
bc
bc
zz
bc
bc
bc
zz
"}
(18,1,1) = {"
SB
SB
SB
SB
Gt
Gt
Gt
GD
Gt
Gt
Gt
Uz
Xu
bc
fc
zz
Rh
oK
PO
zz
GF
yG
dN
zz
bc
bc
bc
bc
bc
bc
bc
zz
"}
(19,1,1) = {"
SB
SB
SB
SB
Gt
Gt
Gt
Gt
Gt
Gt
Gt
Uz
ip
bc
bc
zz
oK
oK
uY
zz
GF
yG
dN
zz
bc
bc
bc
zz
bc
bc
bc
zz
"}
(20,1,1) = {"
SB
SB
SB
Gt
Gt
Gt
Gt
Gt
Gt
Gt
pM
zz
fn
fn
oK
zz
mf
oK
Tr
zz
GF
yG
dN
zz
bc
bc
bc
zz
bc
bc
bc
zz
"}
(21,1,1) = {"
SB
SB
SB
Gt
Gt
GD
GD
Gt
Gt
Gt
pM
zz
IP
IP
eG
zz
VT
jj
YJ
zz
nt
yG
dN
zz
bc
bc
bc
zz
bc
bc
bc
zz
"}
(22,1,1) = {"
SB
SB
SB
Gt
Gt
Gt
Gt
Gt
Gt
Gt
Gt
zz
zz
zz
zz
zz
zz
zz
zz
zz
GF
yG
dN
zz
zz
zz
zz
zz
zz
zz
zz
zz
"}
(23,1,1) = {"
SB
SB
SB
SB
Gt
Gt
Gt
Gt
GD
Gt
Gt
zz
bc
bc
bc
bc
bc
bc
bc
zz
lP
yG
dN
zz
Hb
bc
bc
bc
bc
bc
bc
zz
"}
(24,1,1) = {"
SB
SB
SB
SB
Gt
Gt
AN
Gt
Gt
Gt
Gt
zz
bc
bc
bc
bc
bc
bc
WP
zz
GF
yG
dN
zz
bc
bc
bc
bc
bc
bc
bc
zz
"}
(25,1,1) = {"
SB
SB
SB
SB
Gt
Gt
Gt
Gt
Gt
Gt
Gt
zz
zz
zz
zz
zz
zz
zz
zz
zz
uP
yG
dN
zz
zz
zz
zz
zz
zz
zz
zz
zz
"}
(26,1,1) = {"
SB
SB
SB
SB
Gt
Gt
Gt
Gt
Gt
Gt
Gt
zz
bc
bc
bc
bc
bc
bc
bc
CX
GF
yG
pP
zz
bc
zz
zX
zX
zX
Kz
Kz
zz
"}
(27,1,1) = {"
SB
SB
SB
SB
SB
Gt
Gt
Gt
Gt
Gt
Gt
zz
bc
bc
bc
bc
bc
bc
bc
zz
uP
yG
dN
Lc
bc
bc
bc
bc
bc
bc
Ig
zz
"}
(28,1,1) = {"
SB
SB
SB
SB
SB
SB
Gt
Gt
Gt
Gt
Gt
zz
bc
bc
bc
bc
zz
zz
zz
zz
lg
Ou
pP
zz
bc
zz
zX
zX
zX
zX
zX
zz
"}
(29,1,1) = {"
SB
SB
SB
SB
SB
SB
Gt
Gt
Gt
SB
SB
zz
bc
bc
bc
bc
zz
cw
Cu
Ao
th
JU
XV
zz
zz
zz
zz
zz
zz
zz
zz
zz
"}
(30,1,1) = {"
SB
SB
SB
SB
SB
SB
SB
SB
SB
SB
SB
zz
bc
bc
bc
bc
zz
dy
BG
BG
BG
uO
BC
Ao
kJ
zz
bc
bc
bc
bc
bc
bc
"}
(31,1,1) = {"
SB
SB
SB
SB
SB
SB
SB
SB
SB
SB
SB
zz
bc
bc
bc
bc
zz
iJ
BG
BG
Ck
uO
BG
BG
Yx
zz
bc
bc
bc
bc
bc
bc
"}
(32,1,1) = {"
SB
SB
SB
SB
SB
SB
SB
SB
SB
SB
SB
zz
bc
bc
bc
bc
zz
zz
zz
qD
zz
zz
qD
zz
zz
zz
bc
bc
bc
bc
bc
bc
"}
