//MAP CONVERTED BY dmm2tgm.py THIS HEADER COMMENT PREVENTS RECONVERSION, DO NOT REMOVE
"aj" = (
/obj/structure/fence{
	dir = 4
	},
/turf/simulated/floor/outdoors/newdirt/muriki,
/area/space)
"aF" = (
/obj/effect/floor_decal/borderfloor,
/obj/effect/floor_decal/corner/green/border,
/turf/simulated/floor/tiled/old_tile/beige,
/area/muriki/arriveelev)
"cL" = (
/obj/structure/table/hardwoodtable,
/obj/machinery/microwave{
	pixel_y = 9
	},
/turf/simulated/floor/carpet/green,
/area/centcom/living)
"dm" = (
/obj/effect/floor_decal/borderfloor{
	dir = 1
	},
/obj/effect/floor_decal/corner/green/border{
	dir = 1
	},
/turf/simulated/floor/tiled/old_tile/beige,
/area/centcom/living)
"dE" = (
/turf/simulated/floor/tiled/freezer,
/area/centcom/living)
"dI" = (
/turf/simulated/floor/tiled/old_tile/beige,
/area/centcom/living)
"dR" = (
/obj/machinery/light_switch{
	dir = 8;
	pixel_x = 23;
	pixel_y = 24
	},
/turf/simulated/floor/tiled/freezer,
/area/centcom/living)
"fd" = (
/obj/structure/cable/green{
	d1 = 4;
	d2 = 8;
	icon_state = "4-8"
	},
/turf/simulated/floor/tiled/old_tile/beige,
/area/centcom/living)
"fE" = (
/obj/effect/floor_decal/borderfloor,
/obj/effect/floor_decal/corner/green/border,
/obj/effect/floor_decal/corner/green/border,
/turf/simulated/floor/tiled/old_tile/beige,
/area/centcom/living)
"hc" = (
/obj/effect/floor_decal/borderfloor{
	dir = 1
	},
/obj/effect/floor_decal/corner/green/border{
	dir = 1
	},
/obj/effect/landmark{
	name = "JoinLateCyborg"
	},
/turf/simulated/floor/tiled/old_tile/beige,
/area/muriki/arriveelev)
"hr" = (
/obj/structure/bed/chair/sofa/corner/beige,
/turf/simulated/floor/carpet/green,
/area/centcom/living)
"hB" = (
/obj/machinery/washing_machine,
/turf/simulated/floor/tiled/freezer,
/area/centcom/living)
"hE" = (
/turf/simulated/floor/outdoors/newdirt/muriki,
/area/space)
"hS" = (
/obj/effect/floor_decal/borderfloor{
	dir = 10
	},
/obj/effect/floor_decal/corner/green/border{
	dir = 8
	},
/obj/effect/floor_decal/corner/green/border,
/turf/simulated/floor/tiled/old_tile/beige,
/area/centcom/living)
"jK" = (
/obj/machinery/power/apc{
	name = "south bump";
	dir = 1;
	pixel_y = 26
	},
/obj/effect/floor_decal/borderfloor{
	dir = 1
	},
/obj/effect/floor_decal/corner/green/border{
	dir = 1
	},
/obj/structure/cable/green{
	dir = 1
	},
/turf/simulated/floor/tiled/old_tile/beige,
/area/centcom/living)
"kF" = (
/turf/simulated/floor/tiled/milspec,
/area/centcom/living)
"kX" = (
/obj/effect/floor_decal/borderfloor{
	dir = 10
	},
/obj/effect/floor_decal/corner/green/border,
/obj/effect/floor_decal/corner/green/border{
	dir = 8
	},
/turf/simulated/floor/tiled/old_tile/beige,
/area/muriki/arriveelev)
"lx" = (
/obj/structure/closet/crate/bin,
/turf/simulated/floor/tiled/freezer,
/area/centcom/living)
"ly" = (
/obj/structure/table/glass,
/obj/item/weapon/soap/blue_soap,
/obj/item/weapon/reagent_containers/spray/cleaner,
/turf/simulated/floor/tiled/freezer,
/area/centcom/living)
"mM" = (
/obj/machinery/door/airlock/centcom/nameddorm{
	matchnames = list("Tobin", "Praethius");
	name = "Tobin's Residence"
	},
/turf/simulated/floor/tiled/milspec,
/area/centcom/living)
"oj" = (
/obj/structure/table/hardwoodtable,
/obj/machinery/librarywikicomp/personal,
/turf/simulated/floor/tiled/milspec,
/area/centcom/living)
"oZ" = (
/obj/structure/window/reinforced{
	dir = 8
	},
/turf/simulated/floor/carpet/green,
/area/centcom/living)
"qq" = (
/obj/structure/bed/chair/sofa/left/beige{
	dir = 8
	},
/turf/simulated/floor/carpet/green,
/area/centcom/living)
"qu" = (
/obj/structure/table/hardwoodtable,
/obj/item/device/flashlight/lamp/green{
	pixel_x = -6;
	pixel_y = 14
	},
/obj/item/device/flashlight/pen,
/turf/simulated/floor/carpet/green,
/area/centcom/living)
"rr" = (
/obj/structure/table/rack/shelf/steel,
/turf/simulated/floor/tiled/freezer,
/area/centcom/living)
"rV" = (
/obj/machinery/power/smes/buildable,
/obj/structure/cable/green{
	d1 = 1;
	d2 = 2;
	icon_state = "1-2"
	},
/turf/simulated/floor/tiled/milspec,
/area/centcom/living)
"sg" = (
/obj/effect/landmark{
	name = "JoinLateCyborg"
	},
/turf/simulated/floor/tiled/old_tile/beige,
/area/muriki/arriveelev)
"sI" = (
/obj/structure/bed/chair/bay/comfy/blue{
	dir = 4
	},
/turf/simulated/floor/tiled/milspec,
/area/centcom/living)
"ti" = (
/turf/simulated/wall,
/area/space)
"tp" = (
/obj/machinery/power/grounding_rod/pre_mapped,
/turf/simulated/floor/outdoors/newdirt/muriki,
/area/space)
"tG" = (
/obj/structure/hoist,
/turf/simulated/floor/tiled/milspec,
/area/centcom/living)
"tX" = (
/obj/effect/floor_decal/corner/green/bordercorner{
	dir = 8
	},
/turf/simulated/floor/tiled/old_tile/beige,
/area/muriki/arriveelev)
"uq" = (
/obj/effect/floor_decal/borderfloor,
/obj/effect/floor_decal/borderfloor,
/obj/effect/floor_decal/corner/green/border,
/turf/simulated/floor/tiled/old_tile/beige,
/area/centcom/living)
"vb" = (
/obj/structure/coatrack,
/obj/machinery/light_switch{
	dir = 1;
	pixel_y = -26
	},
/turf/simulated/floor/tiled/milspec,
/area/centcom/living)
"vC" = (
/obj/structure/table/rack/shelf/steel,
/turf/simulated/floor/tiled/milspec,
/area/centcom/living)
"vZ" = (
/obj/structure/grille,
/obj/structure/window/reinforced{
	dir = 1
	},
/obj/structure/window/reinforced{
	health = 1e+006
	},
/turf/space,
/area/centcom/living)
"xi" = (
/obj/structure/cable/green{
	d1 = 4;
	d2 = 8;
	icon_state = "4-8"
	},
/obj/structure/cable/green{
	d1 = 4;
	d2 = 8;
	icon_state = "4-8"
	},
/turf/simulated/floor/tiled/old_tile/beige,
/area/centcom/living)
"yd" = (
/obj/effect/floor_decal/borderfloor{
	dir = 8
	},
/obj/effect/floor_decal/corner/green/border{
	dir = 8
	},
/turf/simulated/floor/tiled/old_tile/beige,
/area/centcom/living)
"yZ" = (
/obj/effect/floor_decal/borderfloor{
	dir = 9
	},
/obj/effect/floor_decal/corner/green/border{
	dir = 1
	},
/obj/effect/floor_decal/corner/green/border{
	dir = 8
	},
/turf/simulated/floor/tiled/old_tile/beige,
/area/muriki/arriveelev)
"za" = (
/obj/structure/closet/secure_closet/freezer/meat,
/turf/simulated/floor/tiled/eris/white/panels,
/area/centcom/living)
"zf" = (
/obj/structure/closet/crate/bin,
/turf/simulated/floor/tiled/milspec,
/area/centcom/living)
"zT" = (
/obj/structure/cable/green{
	d1 = 4;
	d2 = 8;
	icon_state = "4-8"
	},
/turf/simulated/floor/tiled/milspec,
/area/centcom/living)
"Ad" = (
/obj/effect/floor_decal/borderfloor{
	dir = 1
	},
/obj/effect/floor_decal/corner/green/border{
	dir = 1
	},
/obj/effect/floor_decal/corner/green/border{
	dir = 1
	},
/turf/simulated/floor/tiled/old_tile/beige,
/area/centcom/living)
"Aw" = (
/obj/effect/floor_decal/borderfloor{
	dir = 1
	},
/obj/effect/floor_decal/borderfloor{
	dir = 1
	},
/obj/effect/floor_decal/corner/green/border{
	dir = 1
	},
/turf/simulated/floor/tiled/old_tile/beige,
/area/centcom/living)
"Ay" = (
/obj/structure/closet/wardrobe,
/turf/simulated/floor/tiled/freezer,
/area/centcom/living)
"AQ" = (
/obj/structure/fence/door,
/turf/simulated/floor/outdoors/newdirt/muriki,
/area/space)
"AS" = (
/obj/machinery/light_switch{
	dir = 1;
	pixel_y = -26
	},
/turf/simulated/floor/tiled/milspec,
/area/centcom/living)
"Bg" = (
/turf/space,
/area/centcom/living)
"BO" = (
/obj/structure/cable/green{
	d1 = 1;
	d2 = 2;
	icon_state = "1-2"
	},
/obj/machinery/door/airlock/centcom{
	name = "General Access";
	req_access = list(101)
	},
/turf/space,
/area/centcom/living)
"CC" = (
/obj/effect/landmark{
	name = "JoinLateElevator"
	},
/turf/simulated/floor/tiled/old_tile/beige,
/area/muriki/arriveelev)
"EE" = (
/obj/effect/floor_decal/corner/green/bordercorner{
	dir = 1
	},
/turf/simulated/floor/tiled/old_tile/beige,
/area/muriki/arriveelev)
"Ft" = (
/turf/space,
/area/space)
"FI" = (
/obj/structure/window/reinforced{
	dir = 4
	},
/turf/simulated/floor/tiled/milspec,
/area/centcom/living)
"GG" = (
/obj/structure/closet/secure_closet/freezer/fridge,
/turf/simulated/floor/tiled/eris/white/panels,
/area/centcom/living)
"Hk" = (
/obj/structure/bed/padded,
/obj/item/weapon/bedsheet,
/obj/structure/curtain/bed,
/turf/simulated/floor/carpet/green,
/area/centcom/living)
"HA" = (
/obj/structure/table/hardwoodtable,
/turf/simulated/floor/tiled/milspec,
/area/centcom/living)
"IN" = (
/obj/random/outcrop,
/turf/simulated/floor/outdoors/newdirt/muriki,
/area/space)
"JK" = (
/obj/structure/table/hardwoodtable,
/obj/item/device/flashlight/lamp/green,
/turf/simulated/floor/carpet/green,
/area/centcom/living)
"JL" = (
/turf/simulated/mineral/alt/ignore_mapgen/muriki,
/area/space)
"KG" = (
/turf/simulated/floor/carpet/green,
/area/centcom/living)
"LF" = (
/obj/structure/bed/chair/sofa/right/beige,
/turf/simulated/floor/carpet/green,
/area/centcom/living)
"LT" = (
/obj/effect/floor_decal/borderfloor{
	dir = 1
	},
/obj/effect/floor_decal/corner/green/border{
	dir = 1
	},
/turf/simulated/floor/tiled/old_tile/beige,
/area/muriki/arriveelev)
"Mq" = (
/obj/effect/landmark/start/new_player,
/turf/space,
/area/space)
"Mr" = (
/obj/structure/cable/green{
	d1 = 1;
	d2 = 8;
	icon_state = "1-8";
	dir = 4
	},
/turf/simulated/floor/tiled/milspec,
/area/centcom/living)
"NI" = (
/obj/structure/cable/green{
	d1 = 4;
	d2 = 8;
	icon_state = "4-8"
	},
/obj/structure/cable/green{
	d1 = 1;
	d2 = 8;
	icon_state = "1-8";
	dir = 8
	},
/turf/simulated/floor/tiled/old_tile/beige,
/area/centcom/living)
"Oh" = (
/obj/structure/atmopost,
/turf/simulated/floor/outdoors/newdirt/muriki,
/area/space)
"OU" = (
/obj/machinery/power/smes/buildable,
/obj/structure/cable/green{
	d1 = 1;
	d2 = 8;
	icon_state = "1-8";
	dir = 8
	},
/turf/simulated/floor/tiled/milspec,
/area/centcom/living)
"Pb" = (
/obj/structure/dogbed,
/obj/item/toy/plushie/green_dragon,
/obj/item/toy/plushie/tabby_cat,
/turf/simulated/floor/carpet/green,
/area/centcom/living)
"Qe" = (
/obj/structure/table/glass,
/obj/item/clothing/under/bathrobe,
/obj/item/clothing/under/bathrobe,
/obj/item/weapon/towel/random,
/obj/item/weapon/towel/random,
/obj/item/weapon/towel/random,
/obj/item/weapon/reagent_containers/spray/cleaner,
/turf/simulated/floor/tiled/freezer,
/area/centcom/living)
"Qs" = (
/obj/machinery/smartfridge/drying_rack,
/turf/simulated/floor/tiled/eris/white/panels,
/area/centcom/living)
"RF" = (
/obj/machinery/door/airlock/external{
	frequency = 1380;
	icon = 'icons/obj/doors/shuttledoors.dmi';
	icon_state = "door_locked";
	id_tag = "centcom_dock_airlock";
	locked = 1;
	name = "Cargo Elevator Access";
	req_access = list(13)
	},
/turf/space,
/area/centcom/living)
"To" = (
/obj/machinery/door/airlock/centcom{
	name = "General Access";
	req_access = list(101)
	},
/turf/simulated/floor/tiled/milspec,
/area/centcom/living)
"TK" = (
/obj/effect/landmark/start/visitor,
/turf/simulated/floor/tiled/old_tile/beige,
/area/muriki/arriveelev)
"TM" = (
/turf/simulated/wall,
/area/centcom/living)
"TZ" = (
/obj/item/toy/minigibber{
	desc = "A miniature recreation of NanoTrasen's famous meat grinder. Equipped with a special interlock that prevents insertion of organic material. It functions as a trash can!"
	},
/turf/simulated/floor/tiled/milspec,
/area/centcom/living)
"UH" = (
/obj/effect/floor_decal/borderfloor{
	dir = 9
	},
/obj/effect/floor_decal/corner/green/border{
	dir = 8
	},
/obj/effect/floor_decal/corner/green/border{
	dir = 1
	},
/turf/simulated/floor/tiled/old_tile/beige,
/area/centcom/living)
"UR" = (
/obj/item/hoist_kit,
/turf/simulated/floor/tiled/milspec,
/area/centcom/living)
"UV" = (
/obj/structure/cable/green{
	d1 = 1;
	d2 = 8;
	icon_state = "1-8"
	},
/turf/simulated/floor/tiled/old_tile/beige,
/area/centcom/living)
"WC" = (
/obj/structure/table/hardwoodtable,
/obj/item/weapon/gun/energy/sizegun,
/turf/simulated/floor/carpet/green,
/area/centcom/living)
"WL" = (
/obj/machinery/shower,
/obj/structure/curtain/open/privacy,
/turf/simulated/floor/tiled/freezer,
/area/centcom/living)
"WP" = (
/turf/simulated/floor/tiled/old_tile/beige,
/area/muriki/arriveelev)
"XL" = (
/obj/effect/floor_decal/borderfloor,
/obj/effect/floor_decal/corner/green/border,
/turf/simulated/floor/tiled/old_tile/beige,
/area/centcom/living)
"Ye" = (
/obj/structure/mirror{
	dir = 8;
	pixel_x = -32
	},
/obj/structure/sink{
	dir = 8;
	pixel_x = -12
	},
/turf/simulated/floor/tiled/freezer,
/area/centcom/living)
"Yk" = (
/turf/closed/indestructible/splashscreen,
/area/space)
"YK" = (
/obj/effect/floor_decal/borderfloor{
	dir = 1
	},
/obj/effect/floor_decal/corner/green/border{
	dir = 1
	},
/obj/structure/cable/green{
	d1 = 1;
	d2 = 2;
	icon_state = "1-2"
	},
/obj/structure/cable/green{
	d1 = 1;
	d2 = 2;
	icon_state = "1-2"
	},
/turf/simulated/floor/tiled/old_tile/beige,
/area/centcom/living)
"ZT" = (
/obj/machinery/door/airlock/centcom{
	name = "General Access";
	req_access = list(101)
	},
/turf/space,
/area/centcom/living)

(1,1,1) = {"
Ft
Ft
Ft
Ft
Ft
Ft
Ft
Ft
Ft
Ft
Ft
Ft
Ft
Ft
Ft
Ft
Ft
Ft
Ft
Ft
Ft
Ft
Ft
Ft
Ft
Ft
Ft
Ft
Ft
Ft
Ft
Ft
Ft
Ft
Ft
Ft
Ft
Ft
Ft
Ft
Ft
Ft
Ft
Ft
Ft
Ft
Ft
ti
ti
ti
ti
ti
ti
ti
ti
ti
ti
ti
ti
ti
ti
ti
ti
ti
"}
(2,1,1) = {"
Ft
Ft
Ft
Ft
Ft
Ft
Ft
Ft
Ft
Ft
Ft
Ft
Ft
Ft
Ft
Ft
Ft
Ft
Ft
Ft
Ft
Ft
Ft
Ft
Ft
Ft
Ft
Ft
Ft
Ft
Ft
Ft
Ft
Ft
Ft
Ft
Ft
Ft
Ft
Ft
Ft
Ft
Ft
Ft
Ft
Ft
Ft
ti
Ft
Ft
Ft
Ft
Ft
Ft
Ft
Ft
Ft
Ft
Ft
Ft
Ft
Ft
Yk
ti
"}
(3,1,1) = {"
Ft
Ft
Ft
Ft
Ft
Ft
Ft
Ft
Ft
Ft
Ft
Ft
Ft
Ft
Ft
Ft
Ft
Ft
Ft
Ft
Ft
Ft
Ft
Ft
Ft
Ft
Ft
Ft
Ft
Ft
Ft
Ft
Ft
Ft
Ft
Ft
Ft
Ft
Ft
Ft
Ft
Ft
Ft
Ft
Ft
Ft
Ft
ti
Ft
Ft
Ft
Ft
Ft
Ft
Ft
Ft
Ft
Ft
Ft
Ft
Ft
Ft
Ft
ti
"}
(4,1,1) = {"
Ft
Ft
Ft
Ft
Ft
Ft
Ft
Ft
Ft
Ft
Ft
Ft
Ft
Ft
Ft
Ft
Ft
Ft
Ft
Ft
Ft
Ft
Ft
Ft
Ft
Ft
Ft
Ft
Ft
Ft
Ft
Ft
Ft
Ft
Ft
Ft
Ft
Ft
Ft
Ft
Ft
Ft
Ft
Ft
Ft
Ft
Ft
ti
Ft
Ft
Ft
Ft
Ft
Ft
Ft
Ft
Ft
Ft
Ft
Ft
Ft
Ft
Ft
ti
"}
(5,1,1) = {"
Ft
Ft
Ft
Ft
Ft
Ft
Ft
Ft
Ft
Ft
Ft
Ft
Ft
Ft
Ft
Ft
Ft
Ft
Ft
Ft
Ft
Ft
Ft
Ft
Ft
Ft
Ft
Ft
Ft
Ft
Ft
Ft
Ft
Ft
Ft
Ft
Ft
Ft
Ft
Ft
Ft
Ft
Ft
Ft
Ft
Ft
Ft
ti
Ft
Ft
Ft
Ft
Ft
Ft
Ft
Ft
Ft
Ft
Ft
Ft
Ft
Ft
Ft
ti
"}
(6,1,1) = {"
Ft
Ft
Ft
Ft
Ft
Ft
Ft
Ft
Ft
Ft
Ft
Ft
Ft
Ft
Ft
Ft
Ft
Ft
Ft
Ft
Ft
Ft
Ft
Ft
Ft
Ft
Ft
Ft
Ft
Ft
Ft
Ft
Ft
Ft
Ft
Ft
Ft
Ft
Ft
Ft
Ft
Ft
Ft
Ft
Ft
Ft
Ft
ti
Ft
Ft
Ft
Ft
Ft
Ft
Ft
Ft
Ft
Ft
Ft
Ft
Ft
Ft
Ft
ti
"}
(7,1,1) = {"
Ft
Ft
Ft
Ft
Ft
Ft
Ft
Ft
Ft
Ft
Ft
Ft
Ft
Ft
Ft
Ft
Ft
Ft
Ft
Ft
JL
JL
JL
Ft
Ft
Ft
Ft
Ft
Ft
Ft
Ft
Ft
Ft
Ft
Ft
Ft
Ft
Ft
Ft
Ft
Ft
Ft
Ft
Ft
Ft
Ft
Ft
ti
Ft
Ft
Ft
Ft
Ft
Ft
Ft
Ft
Ft
Ft
Ft
Ft
Ft
Ft
Ft
ti
"}
(8,1,1) = {"
Ft
Ft
Ft
Ft
Ft
Ft
Ft
Ft
Ft
Ft
Ft
Ft
Ft
Ft
JL
JL
JL
JL
JL
JL
JL
JL
JL
JL
Ft
Ft
Ft
Ft
Ft
Ft
Ft
Ft
Ft
Ft
Ft
Ft
Ft
Ft
Ft
Ft
Ft
Ft
Ft
Ft
Ft
Ft
Ft
ti
Ft
Ft
Ft
Ft
Ft
Ft
Ft
Ft
Ft
Ft
Ft
Ft
Ft
Ft
Ft
ti
"}
(9,1,1) = {"
Ft
Ft
Ft
Ft
Ft
Ft
JL
JL
JL
JL
JL
JL
JL
JL
JL
JL
JL
JL
JL
JL
JL
JL
JL
JL
Ft
Ft
Ft
Ft
Ft
Ft
Ft
Ft
Ft
Ft
Ft
Ft
Ft
Ft
Ft
Ft
Ft
Ft
Ft
Ft
Ft
Ft
Ft
ti
Ft
Ft
Ft
Ft
Ft
Ft
Ft
Mq
Ft
Ft
Ft
Ft
Ft
Ft
Ft
ti
"}
(10,1,1) = {"
Ft
Ft
Ft
Ft
Ft
JL
JL
JL
JL
JL
JL
JL
JL
JL
JL
JL
JL
JL
JL
JL
JL
JL
JL
JL
JL
TM
TM
TM
TM
TM
TM
TM
TM
TM
TM
TM
TM
TM
Ft
Ft
Ft
Ft
Ft
Ft
Ft
Ft
Ft
ti
Ft
Ft
Ft
Ft
Ft
Ft
Ft
Ft
Ft
Ft
Ft
Ft
Ft
Ft
Ft
ti
"}
(11,1,1) = {"
Ft
Ft
Ft
Ft
JL
JL
JL
hE
hE
hE
aj
JL
JL
JL
JL
JL
JL
JL
JL
JL
JL
JL
JL
JL
JL
TM
kF
kF
kF
kF
kF
kF
kF
TM
UH
yd
hS
TM
Ft
Ft
Ft
Ft
Ft
Ft
Ft
Ft
Ft
ti
Ft
Ft
Ft
Ft
Ft
Ft
Ft
Ft
Ft
Ft
Ft
Ft
Ft
Ft
Ft
ti
"}
(12,1,1) = {"
Ft
Ft
Ft
JL
JL
JL
JL
hE
hE
hE
aj
hE
JL
JL
hE
hE
hE
hE
JL
JL
JL
JL
JL
JL
JL
TM
kF
kF
kF
kF
kF
kF
kF
TM
dm
fd
XL
TM
Ft
Ft
Ft
Ft
Ft
Ft
Ft
Ft
Ft
ti
Ft
Ft
Ft
Ft
Ft
Ft
Ft
Ft
Ft
Ft
Ft
Ft
Ft
Ft
Ft
ti
"}
(13,1,1) = {"
Ft
Ft
JL
JL
JL
JL
hE
hE
hE
hE
aj
hE
hE
hE
hE
hE
hE
hE
hE
hE
hE
JL
hE
hE
hE
TM
kF
kF
kF
kF
kF
kF
kF
TM
dm
fd
XL
TM
Ft
Ft
Ft
Ft
Ft
Ft
Ft
Ft
Ft
ti
Ft
Ft
Ft
Ft
Ft
Ft
Ft
Ft
Ft
Ft
Ft
Ft
Ft
Ft
Ft
ti
"}
(14,1,1) = {"
Ft
JL
JL
JL
Ft
Ft
hE
hE
hE
hE
aj
hE
hE
hE
hE
hE
hE
hE
hE
hE
hE
hE
hE
hE
hE
TM
kF
kF
kF
kF
kF
kF
kF
To
dm
fd
XL
TM
Ft
Ft
Ft
Ft
Ft
Ft
Ft
Ft
Ft
ti
Ft
Ft
Ft
Ft
Ft
Ft
Ft
Ft
Ft
Ft
Ft
Ft
Ft
Ft
Ft
ti
"}
(15,1,1) = {"
Ft
JL
JL
Ft
Ft
Ft
hE
hE
hE
hE
AQ
hE
hE
hE
hE
hE
hE
hE
hE
hE
hE
hE
hE
hE
hE
TM
TM
TM
TM
TM
TM
TM
TM
TM
dm
fd
XL
TM
Ft
Ft
Ft
Ft
Ft
Ft
Ft
Ft
Ft
ti
Ft
Ft
Ft
Ft
Ft
Ft
Ft
Ft
Ft
Ft
Ft
Ft
Ft
Ft
Ft
ti
"}
(16,1,1) = {"
Ft
JL
Ft
Ft
Ft
Ft
hE
hE
hE
hE
aj
hE
hE
hE
hE
hE
IN
hE
hE
hE
hE
hE
hE
hE
hE
TM
kF
kF
kF
kF
kF
kF
kF
TM
dm
fd
XL
TM
Ft
Ft
Ft
Ft
Ft
Ft
Ft
Ft
Ft
ti
Ft
Ft
Ft
Ft
Ft
Ft
ti
ti
ti
ti
Ft
Ft
Ft
Ft
Ft
ti
"}
(17,1,1) = {"
Ft
Ft
Ft
Ft
Ft
Ft
hE
hE
hE
hE
aj
hE
hE
hE
hE
hE
hE
hE
hE
hE
hE
hE
hE
hE
hE
TM
kF
kF
kF
kF
kF
kF
kF
TM
dm
fd
uq
TM
Ft
Ft
Ft
Ft
Ft
Ft
Ft
Ft
Ft
ti
ti
ti
ti
ti
ti
ti
ti
ti
ti
ti
ti
ti
ti
ti
ti
ti
"}
(18,1,1) = {"
Ft
Ft
Ft
Ft
Ft
Ft
hE
hE
hE
hE
aj
hE
hE
hE
IN
hE
hE
hE
hE
hE
hE
hE
hE
hE
hE
TM
kF
kF
kF
kF
kF
kF
kF
To
dm
fd
uq
TM
Ft
Ft
Ft
Ft
Ft
Ft
Ft
Ft
Ft
Ft
Ft
Ft
Ft
Ft
Ft
Ft
Ft
Ft
Ft
Ft
Ft
Ft
Ft
Ft
Ft
Ft
"}
(19,1,1) = {"
Ft
Ft
Ft
Ft
Ft
Ft
hE
hE
hE
hE
aj
hE
hE
hE
IN
hE
hE
hE
hE
IN
hE
hE
hE
hE
hE
TM
TM
TM
TM
TM
TM
TM
TM
TM
dm
fd
XL
TM
Ft
Ft
Ft
Ft
Ft
Ft
Ft
Ft
Ft
Ft
Ft
Ft
Ft
Ft
Ft
Ft
Ft
Ft
Ft
Ft
Ft
Ft
Ft
Ft
Ft
Ft
"}
(20,1,1) = {"
Ft
Ft
Ft
Ft
Ft
Ft
hE
hE
JL
JL
JL
hE
hE
hE
hE
hE
hE
hE
hE
hE
hE
hE
hE
hE
hE
TM
WL
dE
Qe
TM
dE
Ye
ly
TM
dm
fd
XL
TM
Ft
Ft
Ft
Ft
Ft
Ft
Ft
Ft
Ft
Ft
Ft
Ft
Ft
Ft
Ft
Ft
Ft
Ft
Ft
Ft
Ft
Ft
Ft
Ft
Ft
Ft
"}
(21,1,1) = {"
Ft
Ft
Ft
Ft
Ft
Ft
hE
hE
JL
JL
JL
JL
JL
hE
hE
hE
hE
hE
hE
hE
hE
hE
hE
hE
hE
TM
dE
dE
dE
dE
dE
dE
lx
TM
dm
fd
XL
TM
Ft
Ft
Ft
Ft
Ft
Ft
Ft
Ft
Ft
Ft
Ft
Ft
Ft
Ft
Ft
Ft
Ft
Ft
Ft
Ft
Ft
Ft
Ft
Ft
Ft
Ft
"}
(22,1,1) = {"
Ft
Ft
Ft
Ft
Ft
Ft
hE
hE
JL
JL
JL
JL
JL
hE
hE
hE
hE
hE
tp
hE
hE
hE
hE
hE
hE
TM
hB
dE
dE
TM
rr
dR
Ay
TM
dm
fd
XL
TM
Ft
Ft
Ft
Ft
Ft
Ft
Ft
Ft
Ft
Ft
Ft
Ft
Ft
Ft
Ft
Ft
Ft
Ft
Ft
Ft
Ft
Ft
Ft
Ft
Ft
Ft
"}
(23,1,1) = {"
Ft
Ft
Ft
Ft
Ft
Ft
hE
hE
JL
JL
JL
JL
JL
hE
hE
hE
hE
hE
hE
hE
hE
hE
hE
hE
hE
TM
TM
TM
TM
TM
TM
dE
TM
TM
dm
fd
XL
TM
Ft
Ft
Ft
Ft
Ft
Ft
Ft
Ft
Ft
Ft
Ft
Ft
Ft
Ft
Ft
Ft
Ft
Ft
Ft
Ft
Ft
Ft
Ft
Ft
Ft
Ft
"}
(24,1,1) = {"
Ft
Ft
Ft
Ft
Ft
Ft
Ft
Ft
JL
JL
JL
JL
JL
hE
IN
hE
hE
hE
hE
hE
hE
hE
hE
hE
hE
TM
tG
UR
vC
TM
TZ
kF
kF
TM
dm
fd
XL
TM
Ft
Ft
Ft
Ft
Ft
Ft
Ft
Ft
Ft
Ft
Ft
Ft
Ft
Ft
Ft
Ft
Ft
Ft
Ft
Ft
Ft
Ft
Ft
Ft
Ft
Ft
"}
(25,1,1) = {"
Ft
Ft
Ft
Ft
Ft
Ft
Ft
JL
JL
JL
JL
JL
JL
hE
hE
hE
hE
hE
hE
hE
hE
hE
hE
hE
hE
TM
FI
FI
kF
kF
kF
kF
kF
TM
jK
NI
XL
TM
Ft
Ft
Ft
Ft
Ft
Ft
Ft
Ft
Ft
Ft
Ft
Ft
Ft
Ft
Ft
Ft
Ft
Ft
Ft
Ft
Ft
Ft
Ft
Ft
Ft
Ft
"}
(26,1,1) = {"
Ft
Ft
Ft
Ft
Ft
Ft
Ft
JL
JL
JL
JL
JL
JL
hE
hE
hE
hE
hE
hE
hE
hE
hE
hE
hE
hE
vZ
HA
kF
AS
TM
kF
kF
vb
TM
dm
fd
XL
TM
Ft
Ft
Ft
Ft
Ft
Ft
Ft
Ft
Ft
Ft
Ft
Ft
Ft
Ft
Ft
Ft
Ft
Ft
Ft
Ft
Ft
Ft
Ft
Ft
Ft
Ft
"}
(27,1,1) = {"
Ft
Ft
Ft
Ft
Ft
Ft
Ft
JL
JL
JL
JL
JL
hE
hE
hE
hE
hE
hE
hE
hE
hE
IN
hE
hE
hE
vZ
HA
kF
kF
TM
zf
kF
kF
mM
dm
fd
XL
TM
Ft
Ft
Ft
Ft
Ft
Ft
Ft
Ft
Ft
Ft
Ft
Ft
Ft
Ft
Ft
Ft
Ft
Ft
Ft
Ft
Ft
Ft
Ft
Ft
Ft
Ft
"}
(28,1,1) = {"
Ft
Ft
Ft
Ft
Ft
Ft
Ft
JL
JL
JL
JL
hE
hE
hE
hE
hE
hE
hE
hE
hE
hE
hE
hE
hE
hE
vZ
vC
kF
sI
TM
KG
KG
qu
TM
dm
fd
XL
TM
Ft
Ft
Ft
Ft
Ft
Ft
Ft
Ft
Ft
Ft
Ft
Ft
Ft
Ft
Ft
Ft
Ft
Ft
Ft
Ft
Ft
Ft
Ft
Ft
Ft
Ft
"}
(29,1,1) = {"
Ft
Ft
Ft
Ft
Ft
Ft
Ft
JL
JL
JL
JL
hE
hE
hE
hE
IN
hE
hE
hE
hE
hE
hE
hE
hE
hE
vZ
vC
kF
oj
TM
cL
KG
za
TM
dm
xi
XL
TM
Ft
Ft
Ft
Ft
Ft
Ft
Ft
Ft
Ft
Ft
Ft
Ft
Ft
Ft
Ft
Ft
Ft
Ft
Ft
Ft
Ft
Ft
Ft
Ft
Ft
Ft
"}
(30,1,1) = {"
Ft
Ft
Ft
Ft
Ft
Ft
Ft
JL
JL
JL
JL
hE
hE
hE
hE
hE
hE
hE
hE
hE
hE
hE
hE
hE
hE
vZ
vC
kF
kF
TM
WC
KG
GG
TM
dm
xi
XL
TM
Ft
Ft
Ft
Ft
Ft
Ft
Ft
Ft
Ft
Ft
Ft
Ft
Ft
Ft
Ft
Ft
Ft
Ft
Ft
Ft
Ft
Ft
Ft
Ft
Ft
Ft
"}
(31,1,1) = {"
Ft
Ft
Ft
Ft
Ft
Ft
Ft
JL
JL
JL
JL
JL
hE
hE
hE
hE
hE
hE
hE
hE
hE
hE
hE
hE
hE
vZ
vC
kF
kF
TM
KG
KG
Qs
TM
dm
xi
XL
TM
Ft
Ft
Ft
Ft
Ft
Ft
Ft
Ft
Ft
Ft
Ft
Ft
Ft
Ft
Ft
Ft
Ft
Ft
Ft
Ft
Ft
Ft
Ft
Ft
Ft
Ft
"}
(32,1,1) = {"
Ft
Ft
Ft
Ft
Ft
Ft
Ft
JL
JL
JL
JL
JL
JL
hE
hE
hE
hE
hE
hE
hE
hE
hE
hE
hE
hE
TM
oZ
oZ
KG
TM
LF
KG
KG
TM
dm
fd
XL
TM
Ft
Ft
Ft
Ft
Ft
Ft
Ft
Ft
Ft
Ft
Ft
Ft
Ft
Ft
Ft
Ft
Ft
Ft
Ft
Ft
Ft
Ft
Ft
Ft
Ft
Ft
"}
(33,1,1) = {"
Ft
Ft
Ft
Ft
Ft
Ft
JL
JL
JL
JL
JL
JL
JL
hE
hE
IN
hE
hE
hE
hE
hE
hE
hE
hE
hE
TM
Hk
Hk
Pb
TM
hr
qq
JK
TM
Ad
fd
XL
TM
Ft
Ft
Ft
Ft
Ft
Ft
Ft
Ft
Ft
Ft
Ft
Ft
Ft
Ft
Ft
Ft
Ft
Ft
Ft
Ft
Ft
Ft
Ft
Ft
Ft
Ft
"}
(34,1,1) = {"
Ft
Ft
Ft
Ft
Ft
Ft
JL
JL
JL
JL
JL
JL
JL
hE
hE
hE
hE
hE
hE
IN
hE
hE
hE
hE
hE
TM
TM
TM
TM
TM
TM
TM
TM
TM
Ad
fd
fE
TM
TM
TM
TM
TM
TM
TM
TM
TM
TM
TM
Ft
Ft
Ft
Ft
Ft
Ft
Ft
Ft
Ft
Ft
Ft
Ft
Ft
Ft
Ft
Ft
"}
(35,1,1) = {"
Ft
Ft
Ft
Ft
Ft
Ft
JL
JL
JL
JL
JL
JL
hE
hE
hE
hE
hE
hE
hE
hE
hE
hE
hE
hE
hE
TM
kF
kF
kF
kF
kF
kF
kF
TM
Aw
fd
fE
TM
Bg
Bg
Bg
Bg
Bg
Bg
Bg
Bg
Bg
TM
Ft
Ft
Ft
Ft
Ft
Ft
Ft
Ft
Ft
Ft
Ft
Ft
Ft
Ft
Ft
Ft
"}
(36,1,1) = {"
Ft
Ft
Ft
Ft
Ft
Ft
JL
JL
JL
JL
JL
JL
hE
hE
hE
hE
hE
hE
hE
hE
hE
hE
hE
hE
hE
TM
kF
kF
kF
kF
kF
kF
kF
TM
Aw
fd
XL
TM
Bg
Bg
Bg
Bg
Bg
Bg
Bg
Bg
Bg
TM
Ft
Ft
Ft
Ft
Ft
Ft
Ft
Ft
Ft
Ft
Ft
Ft
Ft
Ft
Ft
Ft
"}
(37,1,1) = {"
Ft
Ft
Ft
Ft
Ft
Ft
JL
JL
JL
JL
JL
JL
JL
hE
IN
hE
hE
hE
Oh
hE
hE
hE
hE
hE
hE
TM
kF
kF
kF
kF
kF
kF
kF
TM
dm
fd
uq
TM
Bg
Bg
Bg
Bg
Bg
Bg
Bg
Bg
Bg
TM
Ft
Ft
Ft
Ft
Ft
Ft
Ft
Ft
Ft
Ft
Ft
Ft
Ft
Ft
Ft
Ft
"}
(38,1,1) = {"
Ft
Ft
Ft
Ft
Ft
Ft
JL
JL
JL
JL
JL
JL
JL
JL
JL
hE
hE
hE
hE
hE
hE
hE
hE
hE
hE
TM
kF
kF
kF
kF
kF
kF
kF
ZT
dm
xi
XL
TM
Bg
Bg
Bg
Bg
Bg
Bg
Bg
Bg
Bg
TM
Ft
Ft
Ft
Ft
Ft
Ft
Ft
Ft
Ft
Ft
Ft
Ft
Ft
Ft
Ft
Ft
"}
(39,1,1) = {"
Ft
Ft
Ft
Ft
Ft
Ft
Ft
JL
JL
JL
JL
JL
JL
JL
JL
hE
hE
hE
hE
hE
hE
hE
hE
hE
hE
TM
TM
TM
TM
TM
TM
TM
TM
TM
dm
xi
XL
TM
Bg
Bg
Bg
Bg
Bg
Bg
Bg
Bg
Bg
TM
Ft
Ft
Ft
Ft
Ft
Ft
Ft
Ft
Ft
Ft
Ft
Ft
Ft
Ft
Ft
Ft
"}
(40,1,1) = {"
Ft
Ft
Ft
Ft
Ft
Ft
Ft
JL
JL
JL
JL
JL
JL
JL
JL
JL
hE
hE
hE
IN
hE
hE
hE
hE
hE
TM
kF
kF
kF
kF
kF
kF
kF
TM
dm
xi
XL
TM
Bg
Bg
Bg
Bg
Bg
Bg
Bg
Bg
Bg
TM
Ft
Ft
Ft
Ft
Ft
Ft
Ft
Ft
Ft
Ft
Ft
Ft
Ft
Ft
Ft
Ft
"}
(41,1,1) = {"
Ft
Ft
Ft
Ft
Ft
Ft
Ft
Ft
JL
JL
JL
JL
JL
JL
JL
JL
hE
hE
hE
hE
IN
hE
hE
hE
hE
TM
kF
kF
kF
kF
kF
kF
kF
TM
dm
fd
XL
TM
Bg
Bg
Bg
Bg
Bg
Bg
Bg
Bg
Bg
TM
Ft
Ft
Ft
Ft
Ft
Ft
Ft
Ft
Ft
Ft
Ft
Ft
Ft
Ft
Ft
Ft
"}
(42,1,1) = {"
Ft
Ft
Ft
Ft
Ft
Ft
Ft
Ft
Ft
JL
JL
JL
JL
JL
JL
JL
hE
hE
hE
hE
hE
hE
hE
IN
hE
TM
kF
kF
kF
kF
kF
kF
kF
TM
dm
fd
XL
TM
Bg
Bg
Bg
Bg
Bg
Bg
Bg
Bg
Bg
TM
Ft
Ft
Ft
Ft
Ft
Ft
Ft
Ft
Ft
Ft
Ft
Ft
Ft
Ft
Ft
Ft
"}
(43,1,1) = {"
Ft
Ft
Ft
Ft
Ft
Ft
Ft
Ft
Ft
JL
JL
JL
JL
JL
JL
JL
hE
hE
hE
JL
hE
hE
hE
IN
hE
TM
kF
kF
kF
kF
kF
kF
kF
ZT
dm
fd
XL
TM
Bg
Bg
Bg
Bg
Bg
Bg
Bg
Bg
Bg
TM
Ft
Ft
Ft
Ft
Ft
Ft
Ft
Ft
Ft
Ft
Ft
Ft
Ft
Ft
Ft
Ft
"}
(44,1,1) = {"
Ft
Ft
Ft
Ft
Ft
Ft
Ft
Ft
Ft
Ft
Ft
JL
JL
JL
JL
JL
JL
JL
JL
JL
JL
JL
hE
hE
hE
TM
TM
TM
TM
TM
TM
TM
TM
TM
dm
fd
XL
TM
Bg
Bg
Bg
Bg
Bg
Bg
Bg
Bg
Bg
TM
Ft
Ft
Ft
Ft
Ft
Ft
Ft
Ft
Ft
Ft
Ft
Ft
Ft
Ft
Ft
Ft
"}
(45,1,1) = {"
Ft
Ft
Ft
Ft
Ft
Ft
Ft
Ft
Ft
Ft
Ft
Ft
JL
JL
JL
JL
JL
JL
JL
JL
JL
JL
JL
hE
hE
TM
rV
rV
rV
rV
rV
rV
OU
TM
dm
fd
XL
TM
Bg
Bg
Bg
Bg
Bg
Bg
Bg
Bg
Bg
TM
Ft
Ft
Ft
Ft
Ft
Ft
Ft
Ft
Ft
Ft
Ft
Ft
Ft
Ft
Ft
Ft
"}
(46,1,1) = {"
Ft
Ft
Ft
Ft
Ft
Ft
Ft
Ft
Ft
Ft
Ft
Ft
JL
JL
JL
JL
JL
JL
JL
JL
JL
JL
JL
hE
hE
TM
kF
kF
kF
kF
kF
kF
zT
TM
dm
fd
uq
TM
Bg
Bg
Bg
Bg
Bg
Bg
Bg
Bg
Bg
TM
Ft
Ft
Ft
Ft
Ft
Ft
Ft
Ft
Ft
Ft
Ft
Ft
Ft
Ft
Ft
Ft
"}
(47,1,1) = {"
Ft
Ft
Ft
Ft
Ft
Ft
Ft
Ft
Ft
Ft
Ft
Ft
JL
JL
JL
JL
JL
JL
JL
JL
JL
JL
JL
JL
JL
TM
kF
kF
kF
kF
kF
kF
zT
TM
dm
fd
uq
TM
Bg
Bg
Bg
Bg
Bg
Bg
Bg
Bg
Bg
TM
Ft
Ft
Ft
Ft
Ft
Ft
Ft
Ft
Ft
Ft
Ft
Ft
Ft
Ft
Ft
Ft
"}
(48,1,1) = {"
Ft
Ft
Ft
Ft
Ft
Ft
Ft
Ft
Ft
Ft
Ft
Ft
Ft
Ft
JL
JL
JL
JL
JL
JL
JL
JL
JL
JL
JL
TM
kF
kF
kF
kF
kF
kF
Mr
BO
YK
UV
uq
TM
Bg
Bg
Bg
Bg
Bg
Bg
Bg
Bg
Bg
TM
Ft
Ft
Ft
Ft
Ft
Ft
Ft
Ft
Ft
Ft
Ft
Ft
Ft
Ft
Ft
Ft
"}
(49,1,1) = {"
Ft
Ft
Ft
Ft
Ft
Ft
Ft
Ft
Ft
Ft
Ft
Ft
Ft
Ft
JL
JL
JL
JL
JL
JL
JL
JL
JL
JL
JL
TM
TM
TM
TM
TM
TM
TM
TM
TM
dm
dI
XL
TM
TM
TM
TM
TM
TM
TM
TM
TM
TM
TM
Ft
Ft
Ft
Ft
Ft
Ft
Ft
Ft
Ft
Ft
Ft
Ft
Ft
Ft
Ft
Ft
"}
(50,1,1) = {"
Ft
Ft
Ft
Ft
Ft
Ft
Ft
Ft
Ft
Ft
Ft
Ft
Ft
Ft
Ft
JL
JL
JL
JL
JL
JL
JL
JL
JL
JL
Ft
Ft
Ft
Ft
Ft
Ft
Ft
TM
yZ
EE
WP
tX
kX
TM
Ft
Ft
Ft
Ft
Ft
Ft
Ft
Ft
Ft
Ft
Ft
Ft
Ft
Ft
Ft
Ft
Ft
Ft
Ft
Ft
Ft
Ft
Ft
Ft
Ft
"}
(51,1,1) = {"
Ft
Ft
Ft
Ft
Ft
Ft
Ft
Ft
Ft
Ft
Ft
Ft
Ft
Ft
Ft
Ft
Ft
Ft
Ft
JL
JL
JL
Ft
Ft
Ft
Ft
Ft
Ft
Ft
Ft
Ft
Ft
TM
LT
WP
WP
WP
aF
TM
Ft
Ft
Ft
Ft
Ft
Ft
Ft
Ft
Ft
Ft
Ft
Ft
Ft
Ft
Ft
Ft
Ft
Ft
Ft
Ft
Ft
Ft
Ft
Ft
Ft
"}
(52,1,1) = {"
Ft
Ft
Ft
Ft
Ft
Ft
Ft
Ft
Ft
Ft
Ft
Ft
Ft
Ft
Ft
Ft
Ft
Ft
Ft
Ft
Ft
Ft
Ft
Ft
Ft
Ft
Ft
Ft
Ft
Ft
Ft
Ft
TM
LT
TK
TK
WP
aF
TM
Ft
Ft
Ft
Ft
Ft
Ft
Ft
Ft
Ft
Ft
Ft
Ft
Ft
Ft
Ft
Ft
Ft
Ft
Ft
Ft
Ft
Ft
Ft
Ft
Ft
"}
(53,1,1) = {"
Ft
Ft
Ft
Ft
Ft
Ft
Ft
Ft
Ft
Ft
Ft
Ft
Ft
Ft
Ft
Ft
Ft
Ft
Ft
Ft
Ft
Ft
Ft
Ft
Ft
Ft
Ft
Ft
Ft
Ft
Ft
Ft
TM
LT
TK
TK
CC
aF
TM
Ft
Ft
Ft
Ft
Ft
Ft
Ft
Ft
Ft
Ft
Ft
Ft
Ft
Ft
Ft
Ft
Ft
Ft
Ft
Ft
Ft
Ft
Ft
Ft
Ft
"}
(54,1,1) = {"
Ft
Ft
Ft
Ft
Ft
Ft
Ft
Ft
Ft
Ft
Ft
Ft
Ft
Ft
Ft
Ft
Ft
Ft
Ft
Ft
Ft
Ft
Ft
Ft
Ft
Ft
Ft
Ft
Ft
Ft
Ft
Ft
TM
hc
sg
CC
CC
aF
TM
Ft
Ft
Ft
Ft
Ft
Ft
Ft
Ft
Ft
Ft
Ft
Ft
Ft
Ft
Ft
Ft
Ft
Ft
Ft
Ft
Ft
Ft
Ft
Ft
Ft
"}
(55,1,1) = {"
Ft
Ft
Ft
Ft
Ft
Ft
Ft
Ft
Ft
Ft
Ft
Ft
Ft
Ft
Ft
Ft
Ft
Ft
Ft
Ft
Ft
Ft
Ft
Ft
Ft
Ft
Ft
Ft
Ft
Ft
Ft
Ft
TM
hc
sg
CC
CC
aF
TM
Ft
Ft
Ft
Ft
Ft
Ft
Ft
Ft
Ft
Ft
Ft
Ft
Ft
Ft
Ft
Ft
Ft
Ft
Ft
Ft
Ft
Ft
Ft
Ft
Ft
"}
(56,1,1) = {"
Ft
Ft
Ft
Ft
Ft
Ft
Ft
Ft
Ft
Ft
Ft
Ft
Ft
Ft
Ft
Ft
Ft
Ft
Ft
Ft
Ft
Ft
Ft
Ft
Ft
Ft
Ft
Ft
Ft
Ft
Ft
Ft
TM
RF
RF
RF
RF
RF
TM
Ft
Ft
Ft
Ft
Ft
Ft
Ft
Ft
Ft
Ft
Ft
Ft
Ft
Ft
Ft
Ft
Ft
Ft
Ft
Ft
Ft
Ft
Ft
Ft
Ft
"}
(57,1,1) = {"
Ft
Ft
Ft
Ft
Ft
Ft
Ft
Ft
Ft
Ft
Ft
Ft
Ft
Ft
Ft
Ft
Ft
Ft
Ft
Ft
Ft
Ft
Ft
Ft
Ft
Ft
Ft
Ft
Ft
Ft
Ft
Ft
Ft
Ft
Ft
Ft
Ft
Ft
Ft
Ft
Ft
Ft
Ft
Ft
Ft
Ft
Ft
Ft
Ft
Ft
Ft
Ft
Ft
Ft
Ft
Ft
Ft
Ft
Ft
Ft
Ft
Ft
Ft
Ft
"}
(58,1,1) = {"
Ft
Ft
Ft
Ft
Ft
Ft
Ft
Ft
Ft
Ft
Ft
Ft
Ft
Ft
Ft
Ft
Ft
Ft
Ft
Ft
Ft
Ft
Ft
Ft
Ft
Ft
Ft
Ft
Ft
Ft
Ft
Ft
Ft
Ft
Ft
Ft
Ft
Ft
Ft
Ft
Ft
Ft
Ft
Ft
Ft
Ft
Ft
Ft
Ft
Ft
Ft
Ft
Ft
Ft
Ft
Ft
Ft
Ft
Ft
Ft
Ft
Ft
Ft
Ft
"}
(59,1,1) = {"
Ft
Ft
Ft
Ft
Ft
Ft
Ft
Ft
Ft
Ft
Ft
Ft
Ft
Ft
Ft
Ft
Ft
Ft
Ft
Ft
Ft
Ft
Ft
Ft
Ft
Ft
Ft
Ft
Ft
Ft
Ft
Ft
Ft
Ft
Ft
Ft
Ft
Ft
Ft
Ft
Ft
Ft
Ft
Ft
Ft
Ft
Ft
Ft
Ft
Ft
Ft
Ft
Ft
Ft
Ft
Ft
Ft
Ft
Ft
Ft
Ft
Ft
Ft
Ft
"}
(60,1,1) = {"
Ft
Ft
Ft
Ft
Ft
Ft
Ft
Ft
Ft
Ft
Ft
Ft
Ft
Ft
Ft
Ft
Ft
Ft
Ft
Ft
Ft
Ft
Ft
Ft
Ft
Ft
Ft
Ft
Ft
Ft
Ft
Ft
Ft
Ft
Ft
Ft
Ft
Ft
Ft
Ft
Ft
Ft
Ft
Ft
Ft
Ft
Ft
Ft
Ft
Ft
Ft
Ft
Ft
Ft
Ft
Ft
Ft
Ft
Ft
Ft
Ft
Ft
Ft
Ft
"}
(61,1,1) = {"
Ft
Ft
Ft
Ft
Ft
Ft
Ft
Ft
Ft
Ft
Ft
Ft
Ft
Ft
Ft
Ft
Ft
Ft
Ft
Ft
Ft
Ft
Ft
Ft
Ft
Ft
Ft
Ft
Ft
Ft
Ft
Ft
Ft
Ft
Ft
Ft
Ft
Ft
Ft
Ft
Ft
Ft
Ft
Ft
Ft
Ft
Ft
Ft
Ft
Ft
Ft
Ft
Ft
Ft
Ft
Ft
Ft
Ft
Ft
Ft
Ft
Ft
Ft
Ft
"}
(62,1,1) = {"
Ft
Ft
Ft
Ft
Ft
Ft
Ft
Ft
Ft
Ft
Ft
Ft
Ft
Ft
Ft
Ft
Ft
Ft
Ft
Ft
Ft
Ft
Ft
Ft
Ft
Ft
Ft
Ft
Ft
Ft
Ft
Ft
Ft
Ft
Ft
Ft
Ft
Ft
Ft
Ft
Ft
Ft
Ft
Ft
Ft
Ft
Ft
Ft
Ft
Ft
Ft
Ft
Ft
Ft
Ft
Ft
Ft
Ft
Ft
Ft
Ft
Ft
Ft
Ft
"}
(63,1,1) = {"
Ft
Ft
Ft
Ft
Ft
Ft
Ft
Ft
Ft
Ft
Ft
Ft
Ft
Ft
Ft
Ft
Ft
Ft
Ft
Ft
Ft
Ft
Ft
Ft
Ft
Ft
Ft
Ft
Ft
Ft
Ft
Ft
Ft
Ft
Ft
Ft
Ft
Ft
Ft
Ft
Ft
Ft
Ft
Ft
Ft
Ft
Ft
Ft
Ft
Ft
Ft
Ft
Ft
Ft
Ft
Ft
Ft
Ft
Ft
Ft
Ft
Ft
Ft
Ft
"}
(64,1,1) = {"
Ft
Ft
Ft
Ft
Ft
Ft
Ft
Ft
Ft
Ft
Ft
Ft
Ft
Ft
Ft
Ft
Ft
Ft
Ft
Ft
Ft
Ft
Ft
Ft
Ft
Ft
Ft
Ft
Ft
Ft
Ft
Ft
Ft
Ft
Ft
Ft
Ft
Ft
Ft
Ft
Ft
Ft
Ft
Ft
Ft
Ft
Ft
Ft
Ft
Ft
Ft
Ft
Ft
Ft
Ft
Ft
Ft
Ft
Ft
Ft
Ft
Ft
Ft
Ft
"}
